3M Company|Austin|US,3M|Austin|United States,3M|Austin|United States,3M Company|Austin|United States
"Aaron Marcus and Associates, Inc.|Berkeley|US","Aaron Marcus and Associates, Inc.|Berkeley|United States","President, Aaron Marcus and Associates, Inc.|Berkeley|United States"
Aalborg University|Aalborg|Denmark,Aalborg University|Aalborg|Denmark
Aalborg University|Copenhagen|Denmark,Aalborg University|Copenhagen|Denmark
Aalto University|Espoo|Finland,"Aalto University, Department of Media Technology|Espoo|Finland",Aalto University|Espoo|Finland,School of Science Aalto University|Espoo|Finland*,School of Science Aalto University|Espoo|Finland,School of Science Aalto University|Espoo|Finland
Aalto University|Helsinki|Finland,Aalto University|Helsinki|Finland
Aarhus University|Aarhus|Denmark,Aarhus University|Aarhus|Denmark,"DPU - The Danish School of Education, Aarhus University|Copenhagen|Denmark*","DPU - the danish scool of education, aarhus university|Copenhagen|Denmark",University of Aarhus|Aarhus|Denmark
Abertawe Bro Morgannwg University (ABMU) Health Board|Swansea|UK*,Abertawe Bro Morgannwg University (ABMU) Health Board|Swansea|United Kingdom
Academia Sinica|Taipei|Taiwan,Academia Sinica|Taipei|Taiwan*
Accenture|New York|US,Accenture|New York|United States
Active Ingredient|Nottingham|UK,Active Ingredient|Nottingham|United Kingdom
Adobe Systems|Munich|Germany,Adobe|Munich|Germany
Adobe Systems|San Francisco|US,Adobe Systems|San Francisco|United States,Adobe|San Francisco|United States,Adobe Advanced Technology Labs|San Francisco|United States
Adobe Systems|San Jose|US,"Adobe Systems, Inc.|San Jose|United States",Adobe|San Jose|United States
Adobe|Seattle|US,Adobe|Seattle|United States
Aix Marseille University|Aix Marseille|France,Aix Marseille University|Aix Marseille|France,Aix Marseille University|Aix Marseille|France
Akron Children's Hospital|Akron|US,Akron Children's Hospital|Akron|United States
Alcatel-Lucent Bell Labs|Bangalore|India,Alcatel-Lucent Bell Labs|Bangalore|India,Bell Labs Research India|Bangalore|India,Bell Labs Research India|Bangalore|India,"Bell Labs India, Alcatel-Lucent|Bangalore|India","Bell Labs, Alcatel-Lucent|Bangalore|India"
Alcatel-Lucent Bell Labs|Murray Hill|US,Alcatel-Lucent Bell Labs|Murray Hill|United States
Alcatel-Lucent Bell Labs|Nozay|France,Alcatel-Lucent Bell Labs France|Nozay|France
Alcatel-Lucent|Dublin|Ireland,Alcatel-Lucent|Dublin|Ireland
Alcatel-Lucent|Nozay|France,Alcatel-Lucent|Nozay|France
Alexandra Institute|Aarhus|Denmark,Alexandra Institute|Aarhus|Denmark
AmbieSense Ltd|Aberdeen|UK,AmbieSense Ltd|Aberdeen|United Kingdom,AmbiSense Ltd|Aberdeen|United Kingdom
American Institutes for Research|Washington|US,American Institutes for Research|Washington|United States of America,American Institutes for Research|Washington|United States
Amsterdam University of Applied Sciences|Amsterdam|The Netherlands,Amsterdam University of Applied Research|Amsterdam|Netherlands,Amsterdam University of Applied Sciences|Amsterdam|Netherlands
Archimedes Exhibitions GmbH|Berlin|Germany*,Archimedes Exhibitions GmbH|Berlin|Germany
Arizona State University|Mesa|US,Arizona State University|Mesa|United States
Arizona State University|Phoenix|US,Arizona State University|Phoenix|United States
Arizona State University|Tempe|US,Arizona State Univercity|Tempe|USA,Arizona State University|Tempe|United States,arizona state university|tempe|United States,Arizona State University|TEMPE|United States,Arizona State University|Tempe|USA
Arts et Metiers ParisTech|Bordeaux|France,Arts et Metiers ParisTech|Bordeaux|France
Arts et Metiers ParisTech|Paris|France,Arts et Metiers ParisTech|Paris|France
Telecom ParisTech|Paris|France,Telecom ParisTech|PARIS|FRANCE,"Department of Social Science, Telecom Paristech|Paris|France",Telecom ParisTech - CNRS LTCI UMR 5141|Paris|France,Telecom ParisTech - CNRS LTCI UMR 5141|Paris|France,TELECOM ParisTech - CNRS LTCI UMR 5141|Paris|France
University of Alberta|Edmonton|Canada,University of Alberta|Edmonton|Canada,"Advanced Man-Machine Interface Lab, University of Alberta|Edmonton|Canada","Advanced Man-Machine Interface Lab, University of Alberta|Edmonton|Canada"
AT&T Foundry|Palo Alto|US,AT&T Foundry|Palo Alto|United States
AT&T Labs Research|Florham Park|US,AT&T Labs - Research|Florham Park|United States,AT&T Labs|Florham Park|United States
University of Augsburg|Augsburg|Germany,Augsburg University|Augsburg|Germany,Augsburg University|Augsburg|Germany
Augsburg University of Applied Sciences|Augsburg|Germany,Augsburg University of Applied Sciences|Augsburg|Germany
ATR Intelligent Robotics and Communication Laboratories|Soraku-gun|Japan
Australian Museum|Sydney|Australia
Australian National University|Canberra|Australia,"Australian National University, Canberra|Canberra|Australia",Australian National University|Canberra|Australia,The Australian National University|Canberra|Australia*
Ayogo Games Inc.|Vancouver|Canada
Autodesk Research|Toronto|Canada,Autodesk Research|Toronto|Canada
"Autodesk, Inc.|Lake Oswego|US","Autodesk, Inc.|Lake Oswego|United States"
"Autodesk, Inc.|San Francisco|US","Autodesk, Inc.|San Francisco|United States",Autodesk|San Francisco|United States
"Autodesk, Inc.|Waltham|US","Autodesk, Inc.|Waltham|United States"
"Birkbeck College, University of London|London|UK","Birkbeck College, University of London|London|United Kingdom"
"Brain science institute, RIKEN|Wako|Japan","Brain science institute, RIKEN|Wako|Japan"
Babson College|Wellesley|US,Babson College|Wellesley|01778
Backbase|Amsterdam|The Netherlands,Backbase|Amsterdam|Netherlands
Bangladesh University of Engineering and Technology|Dhaka|Bangladesh,Bangladesh University of Engineering and Technology|Dhaka|Bangladesh
Banque Privee Edmond de Rothschild|Geneva|Switzerland,Banque Privee Edmond de Rothschild|Geneva|Switzerland
Bar Ilan University|Ramat Gan|Israel
Bard College|Annandale-on-Hudson|US,Bard Colleg|Annandale-on-Hudson|United States
Barry University|Miami Shores|US,Barry University|Miami Shores|USA,Barry University|Miami Shores|USA
Bath Spa University|Bath|UK,Bath Spa University|Bath|United Kingdom,Bath Spa University|Bath|United Kingdom
Baylor University|Waco|US,Baylor University|Waco|United States
Beat Bullying|London|UK,Beat Bullying|London|United Kingdom
Beihang University|Beijing|China,Beihang University|Beijing|China
Beijing Institute of Fashion Technology|Beijing|China,Beijng Institute of Fashion Technology|Beijing|China
Beijing Institute of Technology|Beijing|China,Beijing Institute of Technology|Beijing|China
Beijing University of Posts and Telecommunications|Beijing|China,Beijing University of Posts and Telecommunications|Beijing|China
Ben-Gurion University of the Negev|Beer-Sheva|Israel,Ben-Gurion University of the Negev|Beer-Sheva|Israel
Benetas|Melbourne|Australia,Benetas|Melbourne|Australia
Beth Israel Deaconess Medical Center|Boston|US,Beth Israel Deaconess Medical Center|Boston|United States
BI Norwegian School of Business|Oslo|Norway,BI Norwegian School of Business|Oslo|Norway
Birzeit University|Birzeit|Israel,Birzeit University|Birzeit|Israel
Blekinge Institute of Technology|Karlskrona|Sweden,Blekinge Institute of Technology|Karlskrona|Sweden
BMW Research and Technology|Munich|Germany,BMW Research and Technology|Munich|Germany
Bonsai Development Corporation|Woodside|US,Bonsai Development Corporation|Woodside|United States
Bowie State University|Bowie|US,Bowie State University|Bowie|United States,Bowie State University|Bowie|United States
Bowling Green State University|Bowling Green|US,Bowling Green State University|Bowling Gree|USA,Bowling Green State University|Bowling Green|United States,Bowling Green State University|Bowling Green|United States
Brigham Young University|Provo|US,Brigham Young University|Provo|Unite States,Brigham Young University|Provo|United States
Bristol University|Bristol|UK,Bristol University|Bristol|United Kingdom,Bristol University|Bristol|UK
British Broadcasting Corporation|London|UK,British Broadcasting Corporation|London|United Kingdom
British Broadcasting Corporation|Manchester|UK,British Broadcasting Corporation|Manchester|United Kingdom,BBC|Manchester|UK,BBC|Manchester|United Kingdom
Brown University|Providence|US,Brown University|Providence|USA
Brunel University|London|UK,Brunel University|London|United Kingdom,Brunel University|Uxbridge|United Kingdom,Brunel University|London|UK
Budapest University of Technology and Economics|Budapest|Hungary,Budapest University of Technology and Economics|Budapest|Hungary
Bunkyo|Tokyo|Japan,Bunkyo|Tokyo|Japan
Bureau of Economic Interpretation|Berkeley|US,Bureau of Economic Interpretation|Berkeley|United States
C-DAC|Pune|India
California College of the Arts|San Francisco|US,California College of the Arts|San Francisco|United States,California College of the Arts|San Francisco|USA
Cambridge City Council|Cambridge|UK,Cambridge City Countil|Cambridge|United Kingdom
Cancer Council Victoria|Carlton|Australia
Canterbury Christ Church University|Canterbury|UK,Canterbury Christ Church University|Canterbury|United Kingdom
Capgemini|Utrecht|The Netherlands*,Capgemini|Utrecht|Netherlands
Caritas Institute of Higher Education|Hong Kong|Hong Kong
Carleton University|Ottawa|Canada
Carnegie Mellon University - Silicon Valley|Moffett Field|US*,Carnegie Mellon University - Silicon Valley|Moffett Field|United States,Carnegie Mellon University - Silicon Valley|Moffett Field|United States,Carnegie Mellon University Silicon Valley|Moffett Field|United States
Carnegie Mellon University|Pittsburgh|US*,Carnegie Mellon University|Pittsburgh|United States,Carnegie Mellon University|Pittsburgh|15213,Carnegie Mellon University|Pittsburgh|USA,Carnegie Mellon|Pittsburgh|United States,Carnegie Mellon|Pittsburgh|United States,Carnegie Melon University|Pittsburgh|United States
Case Western Reserve University|Cleveland|US*,Case Western Reserve University|Cleveland|United States
CASED|Darmstadt|Germany,CASED|Darmstadt|Germany
Catholic University of Milan|Milan|Italy,Catholic University of Milan|Milan|Italy
CBS|Frederiksberg|Denmark,CBS|Frederiksberg|Denmark
Centrum voor Wiskunde en Informatica|Amsterdam|The Netherlands*,Centrum voor Wiskunde en Informatica|Amsterdam|Netherlands,Centrum Wiskunde & Informatica|Amsterdam|The Netherlands,Centrum Wiskunde & Informatica|Amsterdam|Netherlands
Chalmers University of Technology|Gothenburg|Sweden*,Chalmers|Gothenburg|Sweden,"t2i Lab, Chalmers|Gothenburg|Sweden"
Chemnitz University of Technology|Chemnitz|Germany*
China Academy of Art|Hangzhou|China*
Chinese Academy of Sciences|Beijing|China,Chinese Academy of Science|Beijing|China,Institute Of Software Chinese Academy Of Sciences|Beijing|China,"Institute of Software, Chinese Academy of Sciences, Beijing, Beijing|Beijing|China","Institute of Software, Chinese Academy of Sciences|Beijing|China","Institute of Software, Chinese Academy of Sciences|Beijjing|China"
Chinese University of Hong Kong|Hong Kong|China,Chinese University of HongKong|hong kong|Hong Kong,Chinese University of HongKong|HongKong|China
"Cisco System, Inc.|San Jose|US*","Cisco System, Inc.|San Jose|United States",Cisco System|San Jose|United States
Cisco Systems|Boxborough|US*
Citrix Systems|Santa Clara|US*,Citrix Systems|Santa Clara|USA,Citrix Systems|Santa Clara|United States
"City University, London|London|UK*","City University, London|London|United Kingdom",City University|London|UK,City University London|London|United Kingdom,City University London|London|UK
CEA LIST|Fontenay-aux-Roses|France*
CEA LIST|Gif-sur-Yvette|France*
CEA-List|Fontenay-aux-Roses|France
"CEA, LIST|Fontenay-Aux-Roses|France"
"CEA, LIST|Gif-sur-Yvette|France"
CICESE|Ensenada|Mexico*
Clarice Technologies|Pune|India*
Clemson University|Clemson|US*,Clemson University|Clemson|United States,Clemson University|Clemson|United States,Clemson University|Cemson|United States
Clemson University|Greenville|US*,Clemson University|Greenville|United States
CLIPS-IMAG|Grenoble|France*
CMU Portugal|Funchal|Portugal*
CMU|Pittsburgh|US*,CMU|Pittsburgh|United States
CNES|Toulouse|France*
CNR-ISTI|Pisa|Italy*
CNRS LTCI UMR 5141|Paris|France*
CNRS UMR - IRCAM|Paris|France*
CNRS-LTCI UMR 5141|PARIS|FRANCE
CNRS|Grenoble|France*
CNRS|Orsay|France*
College of Information Sciences & Technology|State College|US*,College of Information Sciences & Technology|State College|United States
"College of Media, Arts, Science and Technology|Tsukuba|Japan*"
College of William and Mary|Williamsburg|United States,College of William and Mary|Williamsburg|US*
Columbia University|New York City|US*,Columbia University|New York|United States,Columbia University|New York City|United States
"Computer and Information Sciences, University of Strathclyde|Glasgow|United Kingdom"
"Computer Science and Engineering, DUB Group, University of Washington|Seattle|United States"
"Computer Science and Engineering, DUB Group, University of Washington|Seattle|US*"
"Computer Science Department, University of Maryland|College Park|United States"
Computer Science|Chicago|United States
Copenhagen Business School|Frederiksberg|Denmark*
Copenhagen Institute of Interaction Design|Copenhagen|Denmark*
Cornell University|Ithaca|US*,Cornell University|Ithaca|USA,Cornell University|Ithaca|United States,Cornell University|Ithaca|14853,"Cornell University, Ithaca|Ithaca|United States","Cornell University, Information Science|Ithaca|United States"
Cornell University|Woodside|US*,Cornell University|Woodside|United States,Cornell University|Woodside|United States
Corporation for National Research Initiatives|Reston|US*,Corporation for National Research Initiatives|Reston|United States
"Coursera, Inc.|Mountain View|US*","Coursera, Inc|Mountain View|United States","Coursera, Inc.|Mountain View|United States"
CREATE-NET|Trento|Italy*,CREATE-NET|Trento|ITALY
CREST|Tokyo|Japan*
Crotched Mountain Rehabilitation Center|Greenfield|US*,Crotched Mountain Rehabilitation Center|Greenfield|United States
Cryptography and Computer Algebra|Darmstadt|Germany*
CSIE|Taipei|Taiwan*
CSIR Meraka Institute|Pretoria|South Africa*,CSIR-Meraka|Pretoria|South Africa
CSIRO|Sydney|Australia*,CSIRO|Marsfield|Australia
CUHK|HK|China*
"CUO, Association Leuven|Leuven|Belgium*"
CURE - Center for Usability Research & Engineering|Vienna|Austria*,CURE - Center for Usability Research and Engineering|Vienna|Austria,CURE-Center for Usability Research & Engineering|Vienna|Austria
Curtin University|Perth|Australia,Curtin University of Technology|Perth|Australia
CWI (Centrum voor Wiskunde en Informatica)|Amsterdam|The Netherlands*,CWI (Centrum voor Wiskunde en Informatica)|Amsterdam|Netherlands
Cyprus University of Technology|Limassol|Cyprus*,Cyprus University of Technology|Limasol|Cyprus,Cyprus University of Technology|Lemesos|Cyprus,Cyprus technological university|Limassol|Cyprus,Department of Multimedia and Graphic Arts - Cyprus University of Technology|Limassol|Cyprus
Czestochowa University of Technology|Czestochowa|Poland*
DA-IICT|Ahmedebad|India*
"Dai Nippon Printing Co., Ltd.|Tokyo|Japan"
Dalhousie University|Halifax|Canada
Dalian Maritime University|Dalian|China
Danske Bank|Copenhagen|Denmark
Dartmouth College|Hanover|US,Dartmouth College|Hanover|United States
Data2Text|Aberdeen|UK,Data2Text|Aberdeen|United Kingdom
De Montfort University|Leicester|UK,De Montfort University|Leicester|United Kingdom
Deakin University|Geelong|Australia,"Faculty of Science and Technology, Deakin University|Geelong|Australia"
Delft University of Technology|Delft|The Netherlands,Delft University of Technology|Delft|Netherlands
DePaul University|Chicago|US*,DePaul University|Chicago|United States
Design for Context|Bethesda|US*,Design for Context|Bethesda|United States
"Design Lab, University of Sydney|Sydney|Australia*"
"Design, Northumbria University|Newcastle upon Tyne|United Kingdom"
Designing Associates|San Francisco|US*,Designing Associates|San Francisco|United States
"Deutsche Telekom Laboratories, TU Berlin|Berlin|Germany*"
DFKI GmbH|Saarbrucken|Germany*
DGA|Bagneux|France*
DGAC DSNA|Toulouse|France*
Dhirubhai Ambani Institute of Information and Communication Technology|Gandhinagar|India
Dhirubhai Ambani Institute of Information and Communication Technology|Gandhinagar|India*
DialogDesign|Stenlose|Denmark*
Digital Contents Technologies|Taipei|Taiwan*
Digital Enterprise Research Institute|Galway|Ireland*
Digital Solutions|Billund|Denmark*
Digital Solutions|New York|US*,Digital Solutions|New York|United States
Digital World Research Centre|Guildford|UK*,Digital World Research Centre|Guildford|United Kingdom,"Digital World Research Centre, University of Surrey, UK|Guildford|United Kingdom"
Dingwall Enterprises|Nottingham|UK*,Dingwall Enterprises|Nottingham|United Kingdom
Direct Partners|Marina del Rey|US*,Direct Partners|Marina del Rey|USA
Disney Research|Pittsburgh|US*,Disney Research|Pittsburgh|United States
DNP Information Systems|Shinjuku|Japan*
"Dray & Associates, Inc.|Minneapolis|US*","Dray & Associates, Inc.|Minneapolis|United States","Dray & Associates, Inc.|Minneapolis|United States"
Dresden University of Technology|Dresden|Germany*,Dresden University of Technology|Dresden|Germany,Dresden University of Technology|Dresden|Germany
Drexel University|Philadelphia|US*,Drexel University|Philadelphia|USA,Drexel University|Philadelphia|United States
DSV|Stockholm|Sweden*
"DTU Informatics,  Cognitive systems|Lyngby|Denmark*"
Duke University|Durham|US*,Duke|Durham|United States,Duke University|Durham|United States
Duquesne University|Pittsburgh|US*,Duquesne University|Pittsburgh|United States
Durham University|Durham|UK*,Durham University|Durham|United Kingdom
"e-Media Lab, Groep T - Leuven Engineering College|Leuven|Belgium*","e-Media Lab, Groep T - Leuven Engineering College, Leuven|Leuven|Belgium"
East West University|Dhaka|Bangladesh*
Eastman Kodak Co.|Rochester|US*,Eastman Kodak Co.|Rochester|United States,Eastman Kodak company|Rochester|United States
Ecole Normale Superieure|Paris|France*
EDF R&D|Clamart|France*,EDF R&D|Clamart|FRANCE
"Edinburgh College of Art, Edinburgh University|Edinburgh|UK*","Edinburgh College of Art, Edinburgh University|Edinburgh|United Kingdom"
Edinburgh Napier University|Edinburgh|UK*,Edinburgh Napier University|Edinburgh|Scotland,Edinburgh Napier University|Edinburgh|United Kingdom
Education.com|Redwood City|US*,Education.com|Redwood City|United States
"EECS, UC Berkeley|Berkeley|US*","EECS, UC Berkeley|Berkeley|United States"
Eindhoven University of Technology|Eindhoven|The Netherlands,Eindhoven university of Technology|Eindhoven|The Netherlands,Eindhoven university of Technology|Eindhoven|Netherlands,Department of Industrial Design Eindhoven University of Technology|Eindhoven|Netherlands
Electrical Engineering and Computer Science Department|Berkeley|US*,Electrical Engineering and Computer Science Department|Berkeley|United States
Electronic Arts|Burnaby|Canada*
Elon University|Elon|US*,Elon University|Elon|United States
Elsevier|St. Louis|US*,Elsevier|St. Louis|USA
EmailVision|Clichy|France*
Emory University|Atlanta|US*,Emory University|Atlanta|United States
"Empirical, Inc.|Portland|US*","Empirical, Inc.|Portland|United States","Empirical, Inc.|Portland|United States"
ENAC|Toulouse|France*
Energy Design|Eskilstuna|Sweden*
ENIG|gabes|Tunisia*
ENIS|Sfax|Tunisia*
Ensimag|Grenoble|France*
EPFL|Lausanne|Switzerland*
Ericsson Research|Beijing|China*
Esaote S.p.A.|Firenze|Italy*
Escuela Superior de Ingenieria Informatica. Universidad de Vigo|Ourense|Spain*
ETH Zurich|Zurich|Switzerland*
"ETIC, EA 4432. User Experience Lab|Metz|France*"
European University Cyprus|Nicosia|Cyprus*
"Facebook, Inc.|Menlo Park|US*","Facebook, Inc.|Menlo Park|United States",Facebook|Menlo Park|United States
"Facebook, Inc.|Palo Alto|US*","Facebook, Inc.|Palo Alto|United States"
Faculty of Engineering|Nagano|Japan
Faculty of Human Kinetics|Lisbon|Portugal
FBK-IRST|Povo|Italy*
FBK-IRST|Trento|Italy*,FBK-irst|Trento|Italy
FBK|Povo|Italy*
Fidelity Investments|Boston|US*,Fidelity Investments|Boston|United States
Florida Institute of Technology|Melbourne|US*,Florida Institute of Technology|Melbourne|United States,Florida Institute of Technology|Melbourne|USA
Florida State University|Tallahassee|US*,Florida State University|Tallahassee|United States
Folkwang University of the Arts|Essen|Germany*,Folkwang University of Arts|Essen|Germany
Fondazione Bruno Kessler|Tretno|Italy*,Fondazione Bruno Kessler-IRST|Trento|Italy
Fontys University of Applied Science|Eindhoven|The Netherlands*,Fontys University of Applied Science|Eindhoven|Netherlands
Ford Motor Company|Dearborn|US*,Ford Motor Company|Dearborn|United States
Foundation for Research and Technology - Hellas|Heraklion|Greece*
FrankNoz.com|San Francisco|US*,FrankNoz.com|San Francisco|United States
Fraunhofer FIRST|Berlin|Germany*
Fraunhofer FIT|Sankt Augustin|Germany*
Fraunhofer IAO|Stuttgart|Germany*,Fraunhofer IAO|70569 Stuttgart|Germany
Fraunhofer IESE|Kaiserslautern|Germany*
Fraunhofer IGD|Darmstadt|Germany*
Fraunhofer Institute for Applied Information Technology (FIT)|Sankt Augustin|Germany*,Fraunhofer Institute for Applied Information Technology FIT|Sankt Augustin|Germany,Fraunhofer Institute for Applied Information Technology|Sankt Augustin|Germany
Fraunhofer Institute for Experimental Software Engineering|Kaiserslautern|Germany*
Fraunhofer MEVIS|Bremen|Germany*
Friends of the Cemetery|Cambridge|UK*,Friends of the cemetery|Cambridge|United Kingdom
Frostburg State University|Frostburg|US*,Frostburg State University|Frostburg|United States
FTW Telecommunications Research Center|Vienna|Austria*,FTW Telecommunications Research Center|Vienna|Austria,FTW Telecommunications Research Center Vienna|Vienna|Austria
Fudan University|Shanghai|China*,"Fudan University, China|Shanghai|China"
Fujitsu Limited|Kawasaki|Japan*
FUSE Labs|Redmond|US*,FUSE Labs|Redmond|United States
Future University Hakodate|Hakodate|Japan*
"FX Palo Alto Laboatory, Inc.|Palo Alto|US*","FX Palo Alto Laboatory, Inc.|Palo Alto|United States","FX Palo Alto Laboratory, Inc.|Palo Alto|United States"
FZI Research Center for Information Technology|Karlsruhe|Germany*,FZI Research Center for Information Technologies|Karlsruhe|Germany
Galileo University|Guatemala City|Guatemala*
Games for Learning Institute|New York|US*,Games for Learning Institute|New York|United States
GE Global Research|San Ramon|US*,GE Global Research|San Ramon|United States
GE HealthCare|Buc|France*
George Mason University|Fairfax|US*,George Mason University|Fairfax|USA,George Mason University|Fairfax|United States
Georgia Institute of Technology|Atlanta|US*,Georgia Institute of Technology|Atlanta|USA,Georgia Tech Research Institute|Atlanta|United States,Georgia Tech|Atlanta|United States,Georige Institute of Technology|Atlanta|United States,Georgia Institute of Technology (Georgia Tech)|Atlanta|United States,Georgia Institute of Technology|Atlanta|United States,Georgia Institute of Technology|atlanta|United States,Georgia Institute of Technology|Atlanta|United States,"College of Computing, Georgia Institute of Technology|Atlanta|US*","College of Computing, Georgia Institute of Technology|Atlanta|United States"
German Research Center for Artificial Intelligence (DFKI)|Saarbrucken|Germany
German Research Center for Artificial Intelligence|Kaiserslautern|Germany*
German Research Institute for Artificial Intelligence (DFKI)|Saarbrucken|Germany*,German Research Center for Artificial Intelligence|Saarbruecken|Germany
Gifu University|Gifu|Japan*
Glasgow Caledonian University|Glasgow|Greece
Glasgow Caledonian University|Glasgow|UK*,Glasgow Caledonian University|Glasgow|United Kingdom,Glasgow Caledonian University|Glasgow|United Kingdom
"Goldsmiths, University of London|London|UK*",Goldsmiths Digital Studios|London|United Kingdom,"Goldsmiths College, University of London|london|United Kingdom","Goldsmiths, University of London|London|United Kingdom",Goldsmiths' University of London|London|United Kingdom,"Department of Computing, Goldsmiths, University of London|London|United Kingdom"
Google Research|Mountain View|US*,Google Research|Mountain View|United States,Google Inc|Mountain View|U.S.,
Google UK|London|UK*,Google UK|London|United Kingdom
"Google, Inc.|Mountain View|US*","Google, Inc.|Mountain View|USA","Google, Inc.|Mountain View|United States","Google, Inc.|Mountain VIew|United States"
"Google, Inc.|New York|US*","Google, Inc.|New York|United States"
"Google, Inc.|San Francisco|US*",Google|San Francisco|United States
"Google, Inc.|Sydney|Australia*"
"Google, Switzerland|Zurich|Switzerland*",Google|Zurich|Switzerland,Google Switzerland|Zurich|Switzerland
"Google,|Mountain View|United States",Google|Mountain View|United States,Google Inc.|Mountain View|United States,Google Inc.|Mountain View|United States
Google|New York|United States
Gothenburg University|Gothenburg|Sweden*
Graduate Institute of Networking and Multimedia|Taipei|Taiwan,Graduate Institute of Networking and Multimedia|Taipei City|Taiwan,Graduate Institute of Networking and Multimedia|Taipei|Taiwan,Graduate Institute of Networking and Multimieda|Taipei|Taiwan,Graduate Institution of Multimedia and Networking|Taipei|R.O.C.(Taiwan),Graduate Institution of Multimedia and Networking|Taipei|R.O.C.(Taiwan)
"Graduate School of Information Science and Technology, Osaka University|Osaka|Japan*"
"Graduate School of Library, Information and Media Studies, University of Tsukuba|Tsukuba|Japan*"
"Graduate School of Media Design, Keio University|Yokohama|Japan*","Graduate School of Media Design, Keio University|Yokohama|Japan","Graduate school of Media Design, Keio University|Yokohama|Japan"
Graduate School of Science and Technology Keio University Japan|Yokohama-shi|Japan,Graduate School of Science and Technology Keio University Japan|Yokohama-shi|Japan
Graduate School of Software and Information Science Iwate Prefectural University|Takizawa-mura|Japan
Grameenphone Ltd|Dhaka|Bangladesh*
Graz Medical University|Graz|Austria*
Graz University of Technology|Graz|Austria*
"GREPS, University of Lyon, University Lyon 2|Bron|France*"
Hackerspace.sg|Singapore|Singapore*
Hangzhou Normal University|Hangzhou|China*
Hans Bredow Institute for Media Research|Hamburg|Germany*
"Hanyang Univ.|Seoul|Korea, Republic of"
Hanyang Univ.|Seoul|Republic of Korea*
Hanyang University|Ansan|Korea
Hanyang University|Seoul|Korea*,Hanyang University|Seoul|South Korea,Hanyang Universtiy|Seoul|South Korea,Hanyang University|Seoul|Korea,Hanyang university|Seoul|Korea,"Hanyang University|Seoul|Korea, Republic of"
Hartnell College|Salinas|US*,Hartnell College|Salinas|United States
Harvard Medical School|Cambridge|US*,Harvard Medical School|Cambridge|United States
Harvard Univerisity|Boston|United States
Harvard University|Cambridge|US*,Harvard University|Cambridge|United States
Harvey Mudd College|Claremont|US*,Harvey Mudd College|Claremont|United States
Hasselt University|Diepenbeek|Belgium*
Hasso Plattner Institute|Potsdam|Germany*,Hasso-Plattner-Institut|Potsdam|Germany
"HCII & Heinz College, Carnegie Mellon University, Pittsburgh|Pittsburgh|United States"
"HCII & Heinz College, Carnegie Mellon University, Pittsburgh|Pittsburgh|US*","HCII, Carnegie Mellon University|Pittsbugh|United States","HCII, Carnegie Mellon University|Pittsburgh|United States",HCII|Pittsburgh|United States
HCIL|College Park|US*,HCIL|College Park|United States
Healing and Rebuilding our Communities|Gisenyi|Rwanda*
Hear for Yourself|Seattle|US*,Hear for Yourself|Seattle|United States
HEC Montreal|Montreal|Canada*,HEC montreal|montreal|Canada,HEC Montreal|Montreal|Canada
"Heinz School, Carnegie Mellon University|Pittsburgh|United States"
Hellenic Open University|Patras|Greece*
Helsinki Institute for Information Technology|Helsinki|Finland*,"Helsinki Institute for Information Technology, University of Helsinki|Helsinki|Finland",Helsinki Institute for Information Technology HIIT|Helsinki|Finland,"Helsinki Institute for Information Technology HIIT, University of Helsinki|Helsinki|Finland",Helsinki Institute for Information Technology HIIT / Aalto University|Espoo|Finland
Helsinki University|Helsinki|Finland,"Department of Computer Science, University of Helsinki|Helsinki|Finland"
Helwan|Cairo|Egypt*
Heriot Watt University|Edinburgh|United Kingdom,"Heriot-Watt University, Edinburgh|Edinburgh|United Kingdom"
Heriot-Watt University|Edinburgh|UK*,Heriot-Watt University|Edinburgh|United Kingdom,Heriot-Watt University|Edinburgh|United Kingdom,Heriot-Watt University|Edinburgh|Scotland,
Hewlett Packard|Bangalore|India*
Hewlett Packard|Palo Alto|US*,Hewlett Packard|Palo Alto|United States
Hewlett-Packard Laboratories|Bangalore|India*
HIIT|Helsinki|Finland
Hokkaido University|Sapporo|Japan*
Holland Bloorview Kids Rehabilitation Hospital|Toronto|Canada*
"Honda Research Institute Japan Co., Ltd.|Wako|Japan*","Honda Research Institute Japan Co., Ltd|Wako|Japan","Honda Research Institute Japan Co., Ltd.|Wako|Japan"
Honda Research Institute USA|Mountain View|United States
Honda Research Institute USA|new york|US*,Honda Research Institute USA|new york|United States
Honkalampi Foundation|Joensuu|Finland,Honkalampi foundation|Joensuu|Finland
Horizon Doctoral Training Centre|Nottingham|UK*,Horizon Doctoral Training Centre|Nottingham|United Kingdom
Horizon Hub|Nottingham|UK*,Horizon Hub|Nottingham|United Kingdom
Hosptial for Sick Children|Toronto|Canada*
HP Labs|Palo Alto|US*,HP Labs|Palo Alto|United States
HP|Palo Alto|US*,HP|Palo Alto|United States
HTW Berlin|Berlin|Germany*
Huazhong Univ. of Science & Technology|Wuhan|China*
Human Computer Interaction Institute|Pittsburgh|US*,Human Computer Interaction Institute|Pittsburgh|USA,Human Computer Interaction Institute|Pittsburgh|United States
"Human Computer Interaction Lab, University of Maryland|College Park|United States"
"Human Interaction Project, NTT Service Evolution Laboratories, Yokosuka, Kanagawa|Yokosuka|Japan*"
"Human Interaction Project, NTT Service Evolution Laboratories|Yokosuka|Japan*"
"Human Media Lab, Queen's University, Kingston|Kingston|Canada"
"Human Media Lab, Queen's University|Kingston|Canada"
Human-Computer Interaction Institute|Pittsburgh|US*
Human-Computer Interaction Institute|Pittsburgh|USA
"Human-Computer Interaction Lab, University of Maryland|College Park|United States"
Human-Computer Interaction Lab|College Park|US*,Human-Computer Interaction Lab|College Park|United States
"Human-Computer Interaction, University of California|Santa Cruz|US*","Human-Computer Interaction, University of California|Santa Cruz|United States"
Humboldt Institute for Internet and Society|Berlin|Germany*
Hunan University|Changsha|China*
Ibaraki University|Mito|Japan*
IBBT-KU Leuven|Leuven|Belgium*
IBBT-SMIT/VUB|Brussels|Belgium*
IBBT|Ghent|Belgium*
IBM Almaden Research Center|San Jose|US*,IBM Almaden Research Center|San Jose|United States
IBM CIO's Office|Cambridge|US*,IBM CIO's Office|Cambridge|United States
IBM Japan Ltd.|Osaka|Japan*,IBM Japan Ltd.|Osaka|Japan
IBM Research - Almaden|San Jose|United States
IBM Research - Brazil|Sao Paulo|Brazil
IBM Research - Tokyo|Tokyo|Japan*
IBM Research Lab|New Delhi|India*
"IBM Research,|Cambridge|United States"
"IBM Research,|Hawthorne|United States"
IBM Research|Bangalore|India*
IBM Research|Cambridge|US*,IBM Research|Cambridge|United States
IBM Research|Haifa|Israel*
IBM Research|Hawthorne|US*,IBM Research|Hawthorne|United States
IBM Research|New Delhi|India*
IBM Research|San Jose|US*,IBM Research|San Jose|United States
IBM Research|Sao Paulo|Brazil*
IBM Research|Yorktown Heights|US*,IBM Research|Yorktown Heights|United States
IBM Silicon Valley Lab|San Jose|US*,IBM Silicon Valley Lab|San Jose|United States
IBM Software Group|Boca Raton|US*,IBM Software Group|Boca Raton|United States
IBM Software Group|Cambridge|US*,IBM Software Group|Cambridge|United States
IBM Software Group|Durham|US*,IBM Software Group|Durham|United States
IBM T.J. Watson Research Center|Hawthorne|US*,IBM T.J. Watson Research Center|Hawthorne|USA
IBM T.J. Watson Research Center|Yorktown Heights|US*,IBM T.J. Watson Research Center|Yorktown Heights|USA,IBM T.J. Watson Research Center|Yorktown Heights|United States,IBM T. J. Watson Research Center|Yorktown Heights|United States,IBM T. J. Watson Research|Yorktown Heights|United States,IBM T. J. Watson Research|Yorktown Heights|United States
IBM T.J. Watson Research|Cambridge|US*,IBM T.J. Watson Research|Cambridge|United States
IBM|Armonk|US*,IBM|Armonk|United States
IBM|Boca Raton|US*,IBM|Boca Raton|United States
IBM|Buenos Aires|Argentina*
IBM|Cambridge|US*,IBM|Cambridge|United States
IBM|Haifa|Israel*
IBM|Littleton|US*,IBM|Littleton|United States
IBM|Pescadero|US*,IBM|Pescadero|United States
"ICT&S Center, University of Salzburg|Salzburg|Austria*"
"ID-StudioLab, Delft University of Technology|Delft|The Netherlands*","ID-StudioLab, Delft University of Technology|Delft|Netherlands"
Idaho National Laboratory|Idaho Falls|US*,Idaho National Laboratory|Idaho Falls|United States
Idiap Research Institute|Martigny|Switzerland*
"IEEE, Bangladesh Section|Dhaka|Bangladesh*"
IIIT Hyderabad|Hyderabad|India*
IIT|Kampur|India*
Illinois Institute of Technology (IIT)|Chicago|US*,Illinois Institute of Technology (IIT)|Chicago|United States
Imperial College London|London|UK*,Imperial College London|London|United Kingdom,Imperial College|London|United Kingdom
Incaa Designs|Winslow|US*,Incaa Designs|Winslow|United States
InContext Design|Concord|US*,InContext Design|Concord|United States,InContext|Concord|United States
Indep. Consultant|London|UK*,Indep. Consultant|London|United Kingdom
Independent Scholar|Honolulu|US*,independent scholar|Honolulu|United States
Indian Institute of Technology Guwahati|Guwahati|India*
Indian Institute of Technology Indore|Indore|India*
Indian Institute of Technology Kharagpur|Kharagpur|India*
Indian Institute of Technology|Bombay|India*
Indiana University Bloomington|Bloomington|US*,Indiana University Bloomington|Bloomington|United States,Indiana Univeristy|Bloomington|United States
Indiana University Bloomongton|Bloomington|United States
"Indiana University, Bloomington|Bloomington, IN|United States"
"Indiana University, Bloomington|Bloomington|United States"
"Indiana University, Bloomington|Bloomington|US","Indiana University|Bloomington, IN|United States"
Indiana University|Bloomington|United States
Indiana University|Bloomington|US*,Indiana University|Bloomington|USA
Indiana University|Blooomington|United States
Indiana University|Indianapolis|United States
Indiana-University Purdue University Indianapolis|Indianapolis|United States
Indiana-University Purdue University Indianapolis|Indianapolis|US*
Indraprastha Institute of Information Technology|Delhi|India*,"Indraprastha Institute of Information Technology, Delhi|New Delhi|India",Indraprastha Institute of Information Technology|New Delhi|India
Indraprastha Institute of Information Technology|New Delhi|India*
"Industrial Design Engineering, Delft University of Technology|Delft|Netherlands"
Industrial Systems Institute|Patras|Greece*
INESC-ID|Lisbon|Portugal*
INESC-TEC|Porto|Portugal*
Informatics Institute|Ankara|Turkey*
Information Institute|Qingdao|China*
Information Processing Institute|Warsaw|Poland*,Information Processing Institute|Warszawa|Poland
Information School at the University of Washington|Seattle|United States
"Information Science, Cornell University|Ithaca|United States"
INRIA -  Institut National de Recherche en Informatique et en Automatique|Le Chesnay Cedex|France*
INRIA & Univ Paris-Sud|Orsay|France*
INRIA Bordeaux Sud-Ouest|Bordeaux|France*
INRIA Lille|Lille|France
INRIA Rennes|Rennes|France*
"INRIA, Orsay, France & INRIA Chile|Orsay|France"
"INRIA, Orsay, France & INRIA Chile|Orsay|France*"
"Inria, Univ Paris-Sud & CNRS|Orsay|France"
INRIA|Bordeaux|France*,Inria|Bordeaux|France
INRIA|Lille|France*
INRIA|Orsay|France*
INRIA|Paris|France*
INRIA|Rennes|France*
INRIA|Saclay|France*
INSA de Rennes|Rennes|France*
INSA|Rennes|France*
Institut of Information Systems / University of Siegen|Siegen|Germany
Institut of Information Systems / University of Siegen|Siegen|Germany
"Institute for Computer Graphics and Vision, Graz University of Technology|Graz|Austria*"
Institute for Computer Graphics and Vision|Graz|Austria*
Institute for Design and Assessment of Technology|Vienna|Austria*,Institute for Design and Assessment of Technology|Wien|Austria
"Institute for Infocomm Research, (A*STAR)|Singapore|Singapore*","Institute for Infocomm Research, A*STAR|Singapore|Singapore","Institute for Infocomm Research, Singapore|Singapore|Singapore","Institute for Infocomm Research, Singapore|Singapore|Singapore",Institute for Infocomm Research|Singapore|Singapore,Institute for Infocomm Research|Singapore|Singapore
"Institute for Information Systems, University of Siegen, Siegen, NRW|Siegen|Germany","Institute for Information Systems, University of Siegen|Siegen|Germany"
Institute for Pervasive Computing|Linz|Austria*
Institute of Applied Arts|Hsinchu|Taiwan*
Institute of Art & Technology|Vienna|Austria*
Institute of Communications Engineering|Ulm|Germany*
Institute of Creative Industries design|Tainan|Taiwan*
Institute of Education|London|UK*,Institute of Education|London|United Kingdom
Institute of Human Factors and Ergonomics|Beijing|China*,Institution of Human Factors and Ergonomics|Beijing|China*
Institute of Psychology and Education|Ulm|Germany*
Instituto Politecnico de Castelo Branco|Castelo Branco|Portugal*
Intel and Nokia Joint Innovation Center|Oulu|Finland*,"Intel and Nokia Joint Innovation Center, Oulu|Oulu|Finland"
Intel Collaborative Research Institute for Sustainable Cities|London|UK*,Intel Collaborative Research Institute for Sustainable Cities|London|United Kingdom
Intel Corporation|?|United States
Intel Corporation|Folsom|US*,Intel Corporation|Folsom|United States
Intel Corporation|Hillsboro|US*,Intel Corporation|Hillsboro|United States
Intel Corporation|Santa Clara|US*,Intel Corporation|Santa Clara|United States
Intel Labs|Hillsboro|US*,Intel Labs|Hillsboro|United States,Intel Labs|Hillsboro|United States
Intel Labs|Portland|US*,Intel Labs|Portland|United States
Intel|Beijing|China*,Intel|Beijing|China,Intel|Beijing|China
Intel|Hillsboro|US*,Intel|Hillsboro|United States
Intel|Portland|US*,Intel|Portland|United States
Intel|Santa Clara|US*,Intel|Santa Clara|United States
Interaction Design Centre|Limerick|Ireland*,Interaction design centre|Limerick|Ireland
Interaction Foundry|New York|US*,Interaction Foundry|New York|United States
Interactive Institute|Gothenburg|Sweden*
Interactive Institute|Kista|Sweden*
Interactive Institute|Umea|Sweden*
Intercultural User Interface Consulting (IUIC)|Undorf|Germany*
Interdisciplinary Center (IDC) Herzliya|Herzliya|Israel*
"Interface Ecology Lab, Texas A&M University|College Station|US*","Interface Ecology Lab, Texas A&M University|College Station|United States"
Ionian University|Corfu|Greece*
Iowa State University|Ames|US*,Iowa State University|Ames|United States
IRCAM|Paris|France*
IRISA/INRIA Rennes|Rennes|France*
IRISA/INSA de Rennes|Rennes|France*
"IRIT, CNRS & University of Toulouse|Toulouse|France"*
"IRIT, University Paul Sabatier, Toulouse III|Toulouse|France*"
IRIT|Toulouse|France*
IT University of Copenhagen|Copenhagen|Denmark*,IT-University of Copenhagen|Copenhagen|Denmark,IT University Copenhagen|Copenhagen|Denmark
ITB Consulting|Bonn|Germany*
Ithaca College|Ithaca|US*,Ithaca College|Ithaca|United States
ITP|New York|US*,ITP|New York|United States
ITU|Copenhagen|Denmark*
IUPUI|Indianapolis|US*,IUPUI|Indianapolis|United States
Iwate Prefectural University|Takizawa|Japan*
iXora Technologies|Mountain View|US*,iXora Technologies|Mountain View|United States
Jacobs University Bremen|Bremen|Germany*
Jadavpur University|Kolkata|India*,Jadavpur University|Kolkata|India,Jadavpur university|Kolkata|India
Japan Advanced Institute of Science and Technology|Ishikawa|Japan*,Japan Advanced Institute Science and Technology|Ishikawa|Japan
"Japan Science Technology Agency, ERATO, IGARASHI Design UI Project|Tokyo|Japan*"
JHT Incorporated|Orlando|US*,JHT Incorporated|Orlando|United States
Joanneum Research|Graz|Austria*,JOANNEUM RESEARCH Forschungsgesellschaft mbH|Graz|Austria
Joetsu University of Education|Joetsu|Japan*
Joticon Oy|Helsinki|Finland*
"JST ERATO Igarashi Design Interface Project|Bunkyo, Tokyo|Japan"
JST ERATO Igarashi Design Interface Project|Bunkyo|Japan,JST ERATO IGARASHI Design Interface Project|Bunkyo|Japan,JST ERATO IGARASHI Design Interface Project|Bunkyo|Japan,JST ERATO|Bunkyo-ku|Japan
"JST, PRESTO|Kawaguchi|Japan*"
K.U.Leuven|Leuven|Belgium*
KAIST (Korea Advanced Institute of Science and Technology)|Daejeon|Republic of Korea*,"KAIST,|Daejun|Korea, Republic of",KAIST|Daejeon-si|South Korea,"KAIST|Daejeon|Korea, Republic of",KAIST|Daejeon|South Korea,KAIST|DAEJEON|South Korea,"KAIST|Daejoen|Korea, Republic of","KAIST|Daejon|Korea, Republic of","KAIST|Yusong-gu, Gusong-dong, Daejeon|Korea, Republic of",KAIST (Korea Advanced Institute of Science and Technology)|Daejeon|Republic of Korea,"Department of Industrial Design, KAIST|Daejeon,|Korea, Republic of","Department of Industrial Design, KAIST|Daejeon,|Korea, Republic of","Department of Industrial Design, KAIST|Daejeon|Korea, Republic of","Dept. of Industrial Design, KAIST|Daejeon|Korea, Republic of","Dept. of Industrial Design, KAIST|Daejeon|Republic of Korea"
Kanagawa University|Kanagawa|Japan*
Kanker.nl|Amsterdam|The Netherlands*,Kanker.nl|Amsterdam|Netherlands
Kansai University|Osaka|Japan*
Karolinska Institutet|Stockholm|Sweden*
Karolinska University Hospital|Stockholm|Sweden*
KDDI Evolva Inc.|Chiyoda-ku|Japan*
KDDI R&D Laboratories|Chiyoda-ku|Japan*,KDDI R&D Laboratories|3-10-10 Chiyoda-ku|Japan
Keio University Graduate School of Media Design|Tokyo|Japan*
Keio University|Fujisawa|Japan*
Keio University|Yokohama City|Japan*,Keio University|Yokohama City|Japan,Keio University|Yokohama|Japan,Keio University|Yokohama  City|Japan
"Keio-NUS CUTE Center, Interactive & Digital Media Institute, National University of Singapore|Singapore|Singapore*",Keio-NUS CUTE Center|Singapore|Singapore*,Keio-NUS CUTE center|Singapore|Singapore,Keio-NUS CUTE Center|Singapore|Singapore
Kent State University|Kent|US*,Kent State University|Kent|United States
King Abdulaziz University|Jeddah|Saudi Arabia*
"King's College, London|London|UK*","King's College, London|London|United Kingdom",King's College London|London|United Kingdom
Kingston University|Kingston Upon Thames|UK*,Kingston University|Kingston Upon Thames|United Kingdom,Kingston University|Kingston|United Kingdom
Kingston University|Kingston|Canada*
KIST (Korea Institute of Science and Technology)|Seoul|Republic of Korea*,KIST(Korea Institute of Science and Technology)|Seoul|Republic of Korea,KIST(Korea Institute of Science and Technology)|Seoul|Republic of Korea,"kist|seoul|Korea, Republic of"
"KMD, Keio University|Tokyo|Japan*"
Know-Center GmbH|Graz|Austria*
Kochi University of Technology|Kami|Japan*
Korea Institute of Science and Technology|Seoul|Republic of Korea*,"Korea Institute of Science and Technology|Seoul|Korea, Republic of","Korea Advanced Institute of Science and Technology|Daejeon|Korea, Republic of",Korea Advanced Institute of Science and Technology|Daejeon|Republic of Korea*,"Korea institue of Science and Technology|Seoul|Korea, Republic of"
Korea University|Seoul|Republic of Korea*,"Korea University|Seoul|Korea, Republic of",Korea University|Seoul|Korea
Korean German Institute of Technology|Seoul|Republic of Korea*
KTH - Royal Institute of Technology|Stockholm|Sweden*,KTH - Royal Institute of Technology|Stockholm|Sweden,KTH - The Royal Institute of Technology|Stockholm|Sweden,KTH The Royal Institute of Technology|Stockholm|Sweden,KTH-Royal Institute of Technology|Stockholm|Sweden,KTH|Stockholm|Sweden
KTH|Kista|Sweden*
KU Leuven - University of Leuven|Leuven|Belgium*,KU Leuven|Leuven|Belgium,KU Leuven|Leuven|Belgium,KU Leuven - University of Leuven|Leuven|Belgium
Kunming University of Science and Technology|Kunming|China*,Kunming University of science and technology|Kunming|China
Kyoto University|Kyoto|Japan*
L3S Research Center|Hannover|Germany*
LabHuman / I3B / UPV|Valencia|Spain*
Lahore University of Management Sciences|Lahore|Pakistan*,Lahore University of Management Sciences|Lahore|Pakistan,Lahore University of Management Sciences|Lahore|Pakistan
Lakeside Upper School|Seattle|US*,Lakeside Upper School|Seattle|United States
Lancaster University|Lancaster|UK*,Lancaster university|Lancaster|United Kingdom,Lancaster University|Lancaster|United Kingdom,Lancaster University|Lanacaster|England,Lancaster University|Lancashire|United Kingdom,Lancaster University|Lancaster|Lancashire
"Language Technologies Institute, Carnegie Mellon Univeristy|Pittsburgh|US*",Language Technologies Institute|pittsburgh|United States,"Language Technologies Institute, Carnegie Mellon Univeristy, Pittsburgh|Pittsburgh|United States","Language Technologies Institute, Carnegie Mellon Univeristy|Pittsburgh|United States"
Lappeenranta University of Technology|Lappeenranta|Finland*,"Lappeenranta, University of Technology|Lappeenranta|Finland",Lappeenranta University of Technology|Lappeenranta|Finland
Leads360|El Segundo|US*,Leads360|El Segundo|United States
Learning Research and Development Center|Pittsburgh|US*,Learning Research and Development Center|Pittsburgh|United States
Leibniz University Hannover|Hannover|Germany*
Lextant|Columbus|US*,Lextant|Columbus|United States
LG Electronics Inc.|Seoul|Republic of Korea*,"LG Electronics|Seoul|Korea, Democratic People's Republic of",LG Electronics|Seoul|Republic of Korea,"LG Electronics Inc.|Seoul|Korea, Republic of"
Liaoning Technical University|Huludao|China*
"LIFL & INRIA Lille, University of Lille|Villeneuve d'Ascq|France*"
LIG|Grenoble|France*
LIIHS-IRIT|Toulouse|France*
"LIMSI-CNRS, University Paris South|Orsay Cedex|France*"
LIMSI-CNRS|Orsay|France*,LIMSI-CNRS|Orsay Cedex|France
Lingnan University|Tuen Mun|Hong Kong*
LinkedIn|Mountain View|US*,LinkedIn|Mountain View|United States
LIRIS|Lyon|France*
"LITA, EA 3097. computer Lab|Metz|France*","LITA, EA 3097. computer Lab|Metz|France"
Liverpool John Moores University|Liverpool|UK*,Liverpool John Moores University|Liverpool|United Kingdom,"Liverpool John Moores University, UK|Liverpool|United Kingdom"
Living Research Labs Inc.|Seattle|US*,Living Research Labs Inc.|Seattle|United States,Living Research Labs Inc.|Seattle|United States
Lodz University of Technology|Lodz|Poland*
London Knowledge Lab|London|UK*,London Knowledge Lab|London|United Kingdom
Lorraine University|Metz|France*
Loughborough University|Loughborough|UK*,Loughborough University|Loughborough|United Kingdom,Loughborough University|Loughborough|United Kingdom
Louvain Interaction Laboratory|Louvain La Neuve|Belgium*
Luebeck University of Applied Sciences|Luebeck|Germany*,"Luebeck University of Applied Sciences, Faculty of Electrical Engineering and Computer Science|Luebeck|Germany"
"Luminanze Consulting, LLC|Silver Spring|US*","Luminanze Consulting, LLC|Silver Spring MD 20902|United States"
Lund University|Lund|Sweden,"Certec, Division of Rehabilitation Engineering Research, Department of Design Sciences, Lund University|Lund|Sweden"
Lunghwa University of Science and Technology|Taoyuan|Taiwan*

MABL Labs|Seoul|Republic of Korea*,"MABL Labs|Seoul|Korea, Republic of"
MAD-Faculty|Genk|Belgium*
Madeira Institute of Technology|Funchal|Portugal
Madeira Interactive Technologies Institute|Funchal|Portugal
Madeira-ITI. University of Madeira|Funchal|Portugal*
Makerere University|kampala|Uganda*,"Makerere University, college of Computing & Information Sciences|kampala|Uganda"
Manhattan Associates|Atlanta|US*,Manhattan Associates|Atlanta|United States
Marist College|Poughkeepsie|US*,Marist College|Poughkeepsie|USA
Marquette University|Milwaukee|US*,Marquette University|Milwaukee|USA,Marquette University|Milwaukee|United States
Massachusetts Institute of Technology|Cambridge|US*,Massachusetts Institute of Technology|Cambridge|USA,Massachusetts Institute of Technology|Cambridge|United States,M.I.T.|Cambridge|USA
Mathakazini Village|Mankosi|South Africa*
"MathWorks, Inc|Natick|US*","MathWorks, Inc|Natick|USA"
Max Planck Institute for Human Development|Berlin|Germany*
Max Planck Institute for Informatics|Saarbruecken|Germany*,Max Planck Institute for Informatics|Saarbrucken|Germany
McGill University|Montreal|Canada*
Measuring Usability LLC|Denver|US*,Measuring Usability LLC|Denver|United States
"Medea, Malmo University|Malmo|Sweden*"
"Media Informatics Group, University of Munich (LMU)|Munich|Germany*",Media Informatics Group|Munich|Germany,"Media Informatics Group, University of Munich (LMU)|Munich|Germany"
Media Interaction Lab|Hagenberg|Austria*
MediaTel|London|UK*,MediaTel|London|United Kingdom
Mega Super Awesome Visuals Company|London|UK*,Mega Super Awesome Visuals Company|London|United Kingdom
Meguro-ku|Tokyo|Japan*
Meiji University|Kawasaki|Japan*,Meiji University|Kawasaki-shi|Japan,"Meiji University|1-1-1, Higashimita, Tama-ku,  Kawasaki City|Japan","Meiji University|1-1-1, Higashimita, Tama-ku,  Kawasaki City|Japan"
Miami University|Oxford|US*,Miami University|Oxford|United States
Michigan State Univeristy|East Lansing|US*,Michigan State University|East Lansing|United States,Michigan State University|East Lansing|USA,Michigan State Univeristy|East Lansing|United States
Michigan Technological University|Houghton|US*,MIchigan Technological University|Houghton|United States
Microsoft Applied Sciences Group|Redmond|US*,Microsoft Applied Sciences Group|Redmond|United States
Microsoft Corporation|Beijing|China*
Microsoft Corporation|Redmond|US*,Microsoft Corp|Redmond|United States,Microsoft Corporation|Redmond|U.S.A.,Microsoft Corporation|Redmond|United States
Microsoft Research Asia|Beijing|China
Microsoft Research FUSE Labs|Redmond|US*,Microsoft Research FUSE Labs|Redmond|United States
microsoft research India|Bangalore|India,Microsoft Research India|Bangalore|India,Microsoft Research India|Bangalore|India,Microsoft Research India|Bangalore|India,Microsoft Research|Bangalore|India
Microsoft Research|Cambridge|UK*,Microsoft Research|Cambridge|United Kingdom,Microsoft Research|Cambridge|United Kingdom,Microsoft Research Cambridge|Cambridge|United Kingdom
Microsoft Research|Cambridge|United States,Microsoft Research|Cambridge|USA
Microsoft Research|Hertzelia|Israel*
Microsoft Research|Mountain View|US*,Microsoft Research|Mountain View|United States
Microsoft Research|Redmond|United States,Microsoft Research|Redmond|USA
Microsoft Through Volt|Redmond|United States,Microsoft|Redmond|United States,Microsoft|Redmond|United States
Microsoft|Redmond|USA
Microsoft|Seattle|USA
Microsoft|Sunnyvale|US*,Microsoft|Sunnyvale|United States
Middle East Technical University|Ankara|Turkey*,Middle Ease Technical University|Ankara|Turkey
Middle East Technical University|Mersin|Turkey*
Middlesex University|London|UK*,Middlesex University|London|United Kingdom
Miguel Hernandez University of Elche|Elche|Spain*
MIND Lab|Syracuse|US*,MIND Lab|Syracuse|United States
MindJet|San Francisco|US*,MindJet|San Francisco|United States
Mindloom|Berkeley|US*,Mindloom|Berkeley|United States
MinkHollow Media Ltd.|Cochrane|Canada*
Minnesota State University|Mankato|US*,Minnesota State University|Mankato|United States
Missouri Western State University|Saint Joseph|US*,Missouri Western State University|Saint Joseph|United States
MIT CSAIL|Cambridge|US*,MIT CSAIL|Cambridge|United States
MIT Media Lab|Cambridge|US*,MIT Media Laboratory|Cambridge|United States,MIT|Cambridge|United States,MIT|Cambridge|United States,MIT|Cambridge|USA,"MIT Media Lab, Cambridge|Cambridge|United States",MIT Media Lab|Cambridge|United States
"Mixed Reality Lab, University of Nottingham|Nottingham|UK*","Mixed Reality Lab, University of Nottingham|Nottingham|United Kingdom","Mixed Reality Lab, Computer Science, University of Nottingham|Nottingham|United Kingdom"
Mixed Reality Lab|Singapore|Singapore*
***Mobile Life @ Stockholm University|Kista|Sweden*,Mobiel Life @ Stockholm University|Kista|Sweden,Mobile Life @ SICS|Kista|Sweden*,Mobile Life Centre @ SICS|Kista|Sweden,Mobile Life Centre & Swedish Institute of Computer Science|Kista|Sweden,Mobile Life|Kista|Sweden,Mobile Life@SICS|Kista|Sweden,Mobile Life @ Stockholm University|Stockholm|Sweden,Mobile Life Centre|Stockholm|Sweden,Mobile Life@Stockholm University|Stockholm|Sweden,SICS|Kista|Sweden,SICS|Stockholm|Sweden

"MobileIron, Inc.|Mountain View|US*",MobileIron|Mountain View|United States,"MobileIron, Inc.|Mountain View|United States"
MobileWorks Inc.|Berkeley|US*,MobileWorks Inc.|Berkeley|USA
Modular Projects|Newcastle upon Tyne|UK*,Modular Projects|Newcastle upon Tyne|United Kingdom
monash|Melbourne|Australia*,monash|melbourne|Australia
Montana Tech of The University of Montana|Butte|US*,Montana Tech of The University of Montana|Butte|United States
Montclair State University|Montclair|US*,Montclair State University|Montclair|United States
More Associates|London|UK*,More Associates|London|United Kingdom
"Moscow State Technical University of Radio engineering, Electronics and Automation|Moscow|Russian Federation*"
Motorola Mobility Inc.|Libertyville|US*,Motorola Mobility|Libertyville|United States,Motorola Mobility Inc.|Libertyville|United States,Motorola Labs|Libertyville|United States
Movinto Fun AB|Are|Sweden*
MSU|East Lansing|US*,MSU|East Lansing|United States
Muenster University of Applied Sciences|Muenster|Germany*,"Muenster University of Applied Sciences, Muenster, NRW|Muenster|Germany"
Multimedia Engineering|Hsinchu|Taiwan*,"Multimedia Engineering|Hsinchu|Taiwan, ROC"
"MVS - California, LLC|San Jose|US*","MVS - California, LLC|San Jose|United States"
Nagoaka University of Technology|Nagaoka|Japan*
Nanjing University|Nanjing|China*
Nanyang Technological University|Singapore|Singapore*,Nanyang Technolgical University|Singapore|Singapore,Nanyang Technological University|Singapore|Singapore,Nanyang Technological University|Singapore|Singapore
NASA Ames Research Center|Mountain View|US*,NASA Ames Research Center|Mountain View|United States
NASA Johnson Space Center|Houston|US*,NASA Johnson Space Center|Houston|United States
Nation Taiwan University|Taipei|Taiwan,Nation Taiwan University|Taipei|Taiwan
National Autonomous University of Mexico|Mexico city|Mexico*
National Chenchi University|Taipei|Taiwan*
National Chiao Tung University|Hsinchu|Taiwan*,National Chiao-Tung University|Hsinchu|Taiwan,National Chiao Tung University|Hsin-chu|Taiwan,National Chiao Tung University|Hsinchu City|Taiwan,National Chiao Tung University|Hsinchu|Taiwan
National Defense Medical Center|Taipei|Taiwan,National Defense Medical Center|Taipei 114|Taiwan*
National Endowment for the Humanities|Washington D.C.|US*,National Endowment for the Humanities|Washington D.C.|United States
National Engineering School of Sfax|Sfax|Tunisia,National Engineering School of Sfax|sfax|Tunisia
National ICT Australia|Sydney|Australia,National ICT Australia|Eveleigh|Australia,National ICT Australia|Eveleigh|Australia
National Institute of Advanced Industrial Science and Technology|Tsukuba|Japan*
National Institute of Design|Bangalore|India*
National Institute of Informatics|Tokyo|Japan*
National Palace Museum|Taipei|Taiwan*
National Research Council Canada|Fredericton|Canada*
National Research Council Canada|Moncton|Canada*
National Research Council of Canada|Ottawa|Canada*,National Research Council Canada|Ottawa|Canada
National Research Foundation|Pretoria|South Africa*
National Taipei University|Taipei|Taiwan*
National Taiwan University Hospital|Taipei|Taiwan*
National Taiwan University of Science and Technology|Taipei|Taiwan,National Taiwan University of Science and Technology|Taipei|Taiwan,National Taiwan University of Science and Technology|Taipei|Taiwan,"National Taiwan University of Science and Technology, Taipei|Taipei|Taiwan"
"National Taiwan University, Graduate Institute of Networking and Multimedia|Taipei|Taiwan"
National Taiwan University|Taipei|Taiwan,National Taiwan University|Taipei|Taiwan,"National Taiwan University|Taipei|Taiwan, Province of China",National Taiwan University|Taipei City|Taiwan,National Taiwan University|Taipei|Taiwan,National Taiwan University|Tapei|Taiwan
National Tsing Hua University|HsinChu|Taiwan*,National Tsing Hua University|Hsinchu|Taiwan,National Tsing Hua University|HsinChu|Taiwan,National Tsing Hua University|Hsin Chu|Taiwan
"National University of Ireland, Galway|Galway|Ireland*","National University of Ireland, Galway|Galway|Ireland"
National University of Science and Technology (NUST)|Islamabad|Pakistan*,National University of Sciences and Technology|Islamabad|Pakistan,National University of Science and Technology (NUST)|Islamabad|Pakistan
National University of Singapore|Kent Ridge Crescent|Singapore*
National University of Singapore|Singapore|Singapore*,National University of SIngapore|Singapore|Singapore,National University of Singapore|Singapore|Singapore,National University of Singapore (NUS)|Singapore|Singapore,"National University of Singapore, NUS|Singapore|Singapore"
Naval Research Laboratory|Washington|US*,Naval Research Laboratory|Washington|United States
NC State University|Raleigh|US*,NC State University|Raleigh|United States
NCR Corporation|Dundee|UK*,NCR Corporation|Dundee|United Kingdom,NCR Corporation|Dundee|United Kingdom
NCSU|Raleigh|US*,NCSU|Raleigh|USA,NCSU|Raleigh|United States
Nelson Mandela Metropolitan University|Port Elizabeth|South Africa*
NetEase Research Center (Hangzhou)|Hangzhou|China*
New England Wildflower Society|Framingham|US*,New England Wildflower Society|Framingham|United States
New University of Lisbon|Almada|Portugal*
New York Hall of Science|Corona|US*,New York Hall of Science|Corona|United States
New York Institute of Technology|New York|US*,New York Institute of Technology|new york|USA
New York University - Abu Dhabi|Abu Dhabi|United Arab Emirates*
New York University|New York City|US*,New York University|New York|United States,New York University|New York City|United States
Newcastle University|Newcastle Upon Tyne|UK*,Newcastle University|Newcastle Upon Tyne|England,Newcastle University|Newcastle Upon Tyne|UK,Newcastle University|Newcastle upon Tyne|UK,Newcastle University|Newcastle Upon Tyne|United Kingdom,Newcastle University|Newcastle upon Tyne|United Kingdom,Newcastle University|Newcastle|United Kingdom
"Next Co., Ltd.|Tokyo|Japan*"
NHTV Breda University of Applied Sciences|Breda|The Netherlands*,NHTV Breda University of Applied Sciences|Breda|Netherlands,NHTV University of Applied Sciences|Breda|Netherlands
NICTA|Sydney|Australia*
NiJel.org|Tempe|US*,NiJel.org|Tempe|United States
NMSU|Las cruces|US*,NMSU|Las cruces|USA
Nokia Gate5 GmbH|Berlin|Germany*
Nokia Research Center|Beijing|China*
Nokia Research Center|Espoo|Finland*
Nokia Research Center|Helsinki|Finland*
Nokia Research Center|Palo Alto|US*,Nokia Research Center|Palo Alto|United States,Nokia Research Center|Paolo Alto|United States
Nokia Research Center|Sunnyvale|US*,Nokia Research Center|Sunnyvale|United States
Nokia Research Center|Tampere|Finland*
Nokia|Beijing|China*
Nokia|Sunnyvale|US*,Nokia|Sunnyvale|United States
Norsk Regnesentral/Norwegian Computing Center|Oslo|Norway*
North Carolina State University|Raleigh|US*,North Carolina State University|Raleigh|United States
North South University|Dhaka|Bangladesh*
Northeastern Illinois University|Chicago|US*,Northeastern Illinois University|Chicago|United States
Northeastern University|Boston|US*,Northeastern University|Boston|USA,Northeastern University|Boston|United States
Northeastern University|Shenyang|China*
Northumbria University|Newcastle upon Tyne|UK*,"Northumbria University, School of Design|Newcastle upon Tyne|United Kingdom",Northumbria University|Newcastle Upon Tyne|England,Northumbria University|Newcastle Upon Tyne|UK,Northumbria University|Newcastle upon Tyne|United Kingdom,Northumbria University|Newcastle-upon-Tyne|United Kingdom,Northumbria University|Newcastle|United Kingdom,Northumbria University|Newcastle|United Kingdom
Northwestern University|Chicago|US*,Northwestern University|Chicago|United States
Northwestern University|Evanston|United States,Northwestern University|Evanston|USA,Northwestern University|Evanston|USA
Norwegian University of Science and Technology|Trondheim|Norway*
Notaplan Aps|Aalborg|Denmark*
Nottingham Trent University|Nottingham|UK*
NTU|Nottingham|UK*,NTU|Nottingham|United Kingdom,ntu|nottingham|United Kingdom
NRL|Washington|US*,NRL|Washington|United States
NTT Communication Science Laboratories|Soraku-gun|Japan*
NTT Corporation|Yokosuka|Japan*
NTT Service Evolution Laboratories|Yokosuka|Japan*
NTU|Singapore|Singapore*
Nursing Science|Irvine|US*,Nursing Science|Irvine|United States
NUS Graduate School for Integrative Sciences and Engineering (NGS)|Singapore|Singapore*
NUST|Islamabad|Pakistan
NYU-Poly|New York|US*,NYU-Poly|New York|United States
Ochanomizu University|Bunkyo-ku|Japan*
oDesk|Redwood City|US*,oDesk|Redwood City|United States
OFFIS - Institute for Information Technology|Oldenburg|Germany*,OFFIS Institute for Information Technology|Oldenburg|Germany,OFFIS - Institute for Information Technology|Oldenburg|Germany
Ohio State University|Columbus|US*,Ohio State University|Columbus|United States,Ohio State University|Columbus|USA
"Oki Electric Industry Co., Ltd.|Warabi|Japan"*
Ono Academic College|Kiryat Ono|Israel*
Open Science Initiative|Los Angeles|US*,Open Science Initiative|Los Angeles|United States

Open University of the Netherlands|Heerlen|The Netherlands*,Open University of the Netherlands|Heerlen|Netherlands

Oracle Corporation|Broomfield|US*,Oracle Corporation|Broomfield|United States,Oracle Corporation|Burlington|US,Oracle Corp.|Burlington|US,Oracle|Broomfield|United States
Oracle|Burlington|US*,Oracle|Burlington|United States,Oracle|Burlington|United States
Oracle|Cambridge|US*,Oracle|Cambridge|United States
Oracle|Denver|US*,Oracle|Denver|United States
Oracle|Redwood City|US*,Oracle|Redwood City|United States,Oracle|Redwood Shores|US,ORACLE|REDWOOD SHORES|United States
Oracle|Zapopan|Mexico*,ORACLE|ZAPOPAN|MEXICO
Oregon Health & Science University|Portland|US*,Oregon Health & Science University|Portland|United States
Oregon State University|Corvallis|US*,Oregon State University|Corvallis|United States
Osaka Prefecture University|Osaka|Japan*
Osaka University Dental Hospital|Suita|Japan*
Osaka University|Osaka|Japan*,Osaka University|Osaka|Japan,Osaka University|Suita|Japan,Osaka University|Toyonaka|Japan
Otago Polytechnic|Dunedin|New Zealand*
Otto-von-Guericke-University Magdeburg|Magdeburg|Germany*
ovos GmbH|Vienna|Austria
Oxford Brookes University|Oxford|UK*,Oxford Brookes University|Oxford|United Kingdom
Pacific Northwest National Laboratory|Richland|US*,Pacific Northwest National Laboratory|Richland|United States
Palo Alto Research Center (PARC)|Palo Alto|US*,PARC|Palo Alto|United States,PARC|palo alto|United States,Palo Alto Research Center (PARC)|Palo Alto|United States,Palo Alto Research Center|Palo Alto|United States
Panafold|Mountain View|US*,Panafold|Mountain View|USA,Panafold|Mountain View|United States
Paris Descartes University|Paris|France*
Parsons The New School for Design|New York|US*,Parsons The New School For Design|New York|United States,Parsons The New School for Design|New York|United States
PayPal|Austin|US*,PayPal|Austin|United States
Peking University|Beijing|China*
Pennsylvania State University|University Park|US*,Pennsylvania State Universtiy|University Park|United States,Pennsylvania State University|University Park|United States,Penn State University|State College|United States of America,Penn State University|University Park|United States,"Pennsylvania State University, University Park|State College|United States",Pennsylvania State University|State College|United States
Perth and Kinross Council|Perth|UK*,Perth and Kinross Council|Perth|United Kingdom
Pervasive Media Studio|Bristol|UK*,Pervasive Media Studio|Bristol|United Kingdom
Philips Research|Briarcliff Manor|US*,Philips Research|Briarcliff Manor|United States
Philips Research|Eindhoven|The Netherlands*,Philips Research|Eindhoven|Netherlands,Philips Research Europe|Eindhoven|Netherlands
Philips|Drachten|The Netherlands*,Philips|Drachten|Netherlands
Pitney Bowes Inc.|Shelton|US*,Pitney Bowes Inc.|Shelton|United States
Play|Warsaw|Poland*
Pohang University of Science and Technology (POSTECH)|Pohang|Republic of Korea*,"Pohang University of Science and Technology (POSTECH)|Pohang|Korea, Republic of",Pohang University of Science and Technology|Pohang|Korea,POSTECH|Pohang|Republic of Korea
Politechnic University of Catalonia|Barcelona|Spain*
Politecnico di Milano|Milan|Italy*,Politecnico di Milano|Milano|Italy,Politecnico di Milano|Milano|Italy,Politecnico di Milano|Milan|Italy
Politecnico di Torino|Torino|Italy*
Polytech'Nantes|Nantes|France*
Polytechnic Institute of New York University|Brooklyn|US*,Polytechnic Institute of NYU|Brooklyn|United States,Polytechnic Institute of New York University|Brooklyn|United States
Pomona College|Claremont|US*,Pomona College|Los Angeles|United States,Pomona College|Claremont|United States
Pontifical Catholic University of Rio de Janeiro (PUC-Rio)|Rio de Janeiro|Brazil*
Portland State University|Portland|US*,Portland State University|Portland|United States
Portsaid University|Portsaid|Egypt*
Praekelt Foundation|Hyderabad|India*
Pratt Institute|New York|US*,Pratt Institute|New York|United States
PresenceDisplays|Delft|The Netherlands*,PresenceDisplays|Delft|Netherlands
Princeton University|Princeton|US*,Princeton University|Princeton|USA,Princeton University|Princeton|United States,Princeton Univ.|Princeton|United States
Professional Usability Services|London|UK*,Professional Usability Services|London|United Kingdom
Public Research Center Henri Tudor|Luxembourg-Kirchberg|Luxembourg*,Public Research Centre Henri Tudor|Luxembourg|Luxembourg,Public Research Center Henri Tudor|Luxembourg-Kirchberg|Luxembourg
Public University of Navarra|Pamplona|Spain*,Public University of Navarre|Pamplona|Spain,Public University of Navarre|Pamplona|SPAIN,Public University of Navarra|Pamplona|Spain
PUC-Rio|Rio de Janeiro|Brazil*
PUCRS|Porto Alegre|Brazil*
Purdue University|West Lafayette|US*,Purdue|WEST LAFAYETTE|United States,Purdue University|WEST LAFAYETTE|United States,Purdue University|west lafayette|United States,Purdue University|West Lafayette|United States,Purdue University|West Lafayette|US
Qualcomm Corporate R&D|Cambridge|UK*,Qualcomm Corporate R&D|Cambridge|United Kingdom,Qualcomm R&D|Cambridge|United Kingdom
Qualcomm Technologies Inc.|San Diego|US*,"Qualcomm Technologies, Inc|San Diego|92121",Qualcomm Technology Inc.|San Diego|United States
"Quality and Usability Lab, Deutsche Telekom Laboratories|Berlin|Germany*","Quality and Usability Lab, Telekom Innovation Laboratories, TU Berlin|Berlin|Germany"
"Queen Mary, University of London|London|UK*",Queen Mary University of London|London|UK,Queen Mary University of London|London|United Kingdom,"Queen Mary University, London|London|United Kingdom"
Queen's University|Kingston|Canada*
Queensland University of Technology|Brisbane|Australia*
Rackspace|San Antonio|US*,Rackspace|San Antonio|United States
RadixNova|Pittsford|US*,RadixNova|Pittsford|United States
Rakuten Inc.|Tokyo|Japan*
RealNetworks Through Volt|Seattle|US*,RealNetworks Through Volt|Seattle|United States
RedWhale Software|San Mateo|US*,RedWhale Software|San Mateo|United States
Reflective Thinking|Newcastle upon Tyne|UK*,Reflective Thinking|Newcastle upon Tyne|United Kingdom
Renault|Guyancourt|France*
Research Group Digital Media|Bremen|Germany*
"Research Labs, NTT docomo|Yokosuka|Japan*"
Research Studios Austria|Vienna|Austria*
Reutlingen University|Reutlingen|Germany*
RheinMain University of Applied Sciences|Wiesbaden|Germany*
Rhodes University|Grahamstown|South Africa*
Rice University|Houston|US*,Rice University|Houston|United States
Ritsumeikan University|Kusatsu|Japan*
Ritsumeikan University|Kyoto|Japan*
Rivendel Consulting & Design|Berkeley|US*,Rivendel Consulting & Design|Berkeley|United States
RMIT University|Melbourne|Australia,RMIT|Melbourne|Australia,RMIT University|Melbourne|Australia,RMIT University|Melbourne|Australia,RMIT university|Melbourne|Australia
RNHA|Birmingham|UK*,RNHA|Birmingham|United Kingdom
Rochester Institute of Technology|Rochester|US*,Rochester Institute of Technology|Rochester|United States,Rochester Institute of Technology|Rochester|United States
Roskilde University|Roskilde|Denmark,"Computer Science, Roskilde University|Roskilde|Denmark"
Rotterdam School of Management|Rotterdam|The Netherlands*,Rotterdam School of Management|Rotterdam|Netherlands
Rotterdam University of Applied Sciences|Rotterdam|The Netherlands*,Rotterdam University of applied sciences|Rotterdam|Netherlands
Royal college of Art|London|UK*,Royal college of Art|London|United Kingdom
Royal Free NHS Trust|London|UK*,Royal Free NHS Trust|London|United Kingdom
Royal Holloway|Egham|UK*,Royal Holloway|Egham|United Kingdom
Royal Institute of Technology (KTH)|Stockholm|Sweden*,Royal Institute of Technology|Stockholm|Sweden
Royal Melbourne Institute of Techonology|Melbourne|Australia*
Ruhr-University of Bochum|Bochum|Germany*
Rutgers University|New Brunswick|US*,Rutgers University|New Brunswick|USA,Rutgers Unniversity|new brunswick|United States,Rutgers University|Camden|United States,Rutgers University|New Brunswick|United States,"Rutgers, the State University of New Jersey|New Brunswick|United States","Rutgers, The State University of New Jersey|New Brunswick|United States"
ruwido|Neumarkt|Austria*
RWTH Aachen University|Aachen|Germany*,RWTH Aachen|Aachen|Germany,RWTH-Aachen University|Aachen|Germany
Ryerson University|Toronto|Canada*
Saitama University|Saitama|Japan*,Saitama Univeristy|Saitama|Japan,Saitama University|Saitama|Japan,Saitama university|Saitama|Japan
SAMH Engineering|Blackrock|Ireland*
"Samsung Advanced Institute of Technology (SAIT), Samsung Electronics|Yongin-si|Republic of Korea*","Samsung Advanced Institute of Technology (SAIT), Samsung Electronics|Yongin-si|Korea, Republic of"
Samsung DTL lab|Richardson|US*,Samsung DTL lab|Richardson|United States
Samsung Electronics|Dallas|US*,Samsung Electronics|Dallas|United States
Samsung Electronics|Suwon|Republic of Korea*,"Samsung Electronics|Suwon|Korea, Republic of"
Samsung R&D Research Center|San Jose|US*,Samsung R&D Research Center|San Jose|United States,Samsung Research|San Jose|United States
Samsung Telecom America|Richardson|US*,Samsung Telecom America|Richardson|USA,"Samsung Telecom America, Richardson|Richardson|United States",Samsung Telecom America|Richardson|United States,Samsung Telecommunications America|Richardson|United States
Samsung UX Innovations Lab|San Jose|US*,Samsung UX Innovations Lab|San Jose|United States
Samsung|San Jose|US*,Samsung|San Jose|United States
Samsung|Suwon|Republic of Korea*,"Samsung|Suwon|Korea, Republic of"
San Jose State University|Moffett Field|US*,San Jose State University|Moffett Field|United States
Santa Clara University|Santa Clara|US*,Santa Clara University|Santa Clara|United States
SAP AG|Darmstadt|Germany,SAP Research Darmstadt|Darmstadt|Germany*
SAP AG|Dresden|Germany,"SAP Research, SAP AG|Dresden|Germany*"
SAP AG|Walldorf|Germany*
SAP France|Levallois Perret|France*
SAP Labs India|Bangalore|India*
"SAP Labs, LLC.|Palo Alto|US*","SAP Labs, LLC.|Palo Alto|USA"
SAP Labs|Bangalore|India*,Sap labs|Bangalore|India,SAP labs|Bangalore|India,SAP Labs|Bangalore|India
SAP Research|Karlsruhe|Germany*
SAP|Palo Alto|US*,SAP|Palo Alto|United States
Sapienza - University of Rome|Rome|Italy*
Savannah College of Art and Design|Savannah|US*,Savannah College of Art and Design|Savannah|United States
Scalable Conversations|Berkeley|US*,Scalable Conversations|Berkeley|USA,Scalable Conversations|Berkeley|United States
Seattle Cancer Care Alliance|Seattle|US*,Seattle Cancer Care Alliance|Seattle|United States
Seattle Pacific University|Seattle|US*,Seattle Pacific University|Seattle|United States
Seoul National University|Seoul|Republic of Korea*,"seoul national universiy|seoul|Korea, Republic of","Seoul National University|Seoul|Korea, Republic of"
Shahjalal University of Science & Technology|Sylhet-3114|Bangladesh
Shandong University|Jinan|China*,Shandong University|Jinan|P. R. China
"Sharif University of Technology|Tehran|Iran, Islamic Republic of*","Sharif University of Technology|Tehran|Iran, Islamic Republic of"
Sheffield Hallam University|Sheffield|UK*,Sheffield Hallam University|Sheffield|United Kingdom,Sheffield Hallam University|Sheffiled|UK,Sheffield Hallam University|Sheffiled|UK
Shenzhen Institutes of Advanced Technology (SIAT)|Shenzhen|China,"Shenzhen Institute of Advanced Technology, CAS|Shenzhen|China","Shenzhen Institute of Advanced Technology, CAS|Shenzhen|China",Shenzhen Institutes of Advanced Technology (SIAT)|Shenzhen|China,Shenzhen Institutes of Advanced Technology (SIAT)|Shenzhen|China
Shinshu University|Nagano|Japan,Shinshu University|Ueda|Japan*

Siena College|Loudonville|US*,Siena College|Loudonville|USA
Simcentric Technologies|Melbourne|Australia*
Simon Fraser University|Burnaby|Canada*
Simon Fraser University|Surrey|Canada*,Simon Fraser University|SURREY|Canada,Simon Fraser University|Surrey|Canada
Simon Fraser University|Vancouver|Canada*,"Simon Fraser University, SFU|Vancouver|Canada"
Singapore Management University|Singapore|Singapore*,Singapore Management University|Singapore|Singapore,Singapore Management University|Singapore|Singapore
Singapore National Eyes Center|Singapore|Singapore*
Singapore University of Technology and Design|Singapore|Singapore*,Singapore University of Design and Technology|Singapore|Singapore,Singapore University of Technology and Design|Dover|Singapore

Sino-European Usability Center|Dalian|China*
SINTEF|Oslo|Norway*
Slate Learning|Encinitas|US*,Slate Learning|Encinitas|United States
Small World Consulting|Lancaster|UK*,Small World Consulting|Lancaster|United Kingdom
SMART Technologies|Calgary|Canada*
Sokendai|Tokyo|Japan*,SOKENDAI|Tokyo|Japan
Sony Computer Entertainment|London|UK*,Sony Computer Entertainment|London|United Kingdom
"Sony Computer Science Laboratories, Inc.|Shinagawa-ku|Japan*"
Sony CSL Paris|Paris|France*,Sony CSL|Paris|France
Sony CSL|Tokyo|Japan*
SPARK Experience Design|Rockville|US*,SPARK Experience Design|Rockville|United States
Spelman College|Atlanta|US*,Spelman College||
Spigit Inc.|Pleasanton|US*,Spigit Inc.|Pleasanton|United States
"Ss. Cyril and Methodius University|Skopje|Macedonia, The Former Yugoslav Republic of"
"Ss. Cyril and Methodius University|Skopje|Macedonia, The Former Yugoslav Republic of*"
St. John's School|Houston|US*,St. John's School|Houston|United States
Stanford University|Palo Alto|US*,Stanford University|Palo Alto|United States
Stanford University|Stanford|US*,Stanford University|Stanford|USA,Stanford Unviersity|Stanford|USA,Stanford|Stanford|United States,Stanford University|stanford|United States,Stanford University|Stanford|United States,Stanford University|Stanford|United States of America
Starlab|Barcelona|Spain*
State University of Rio de Janeiro|Rio de janiero|Brazil*,State University of Rio de Janeiro|Rio de janiero|Brazil,State University of Rio de Janeiro|Rio de janiero|Brazil
Stockholm University|Stockholm|Sweden*,Stockholm University|Kista|Sweden
Stony Brook University|Stony Brook|US*,Stony Brook University|Stony Brook|United States
Studio Frankness AB|Stockholm|Sweden*
Suita|Osaka|Japan*
Sultan Qaboos University|Al-Khoudh|Oman*
Sungkyunkwan University|Seoul|Republic of Korea*,"Sungkyunkwan University|Seoul|Korea, Republic of"
SusaGroup|Enschede|The Netherlands*,SusaGroup|Enschede|Netherlands
Swansea University|Swansea|UK*,Swansea University|Swansea|United Kingdom,Swansea University|Swansea|UK,"FIT Lab, Swansea University|Swansea|United Kingdom","Future Interaction Technologies Lab, Swansea University|Swansea|UK"
Swedish Institute of Computer Science|Kista|Sweden*
Swinburne University of Technology|Melbourne|Australia*
Swinburne University Technology (Sarawak Campus)|Kuching|Malaysia*
"Swiss Federal Institute of Technology (EPFL), Lausanne|Lausanne|Switzerland*"
Swiss Federal Institute of Technology (ETH Zurich)|Zurich|Switzerland*,Swiss Federal Institute of Technology Zurich|Zurich|Switzerland
Syntagm Ltd|Abingdon|UK*,Syntagm Ltd|Abingdon|United Kingdom
Syracuse University|Syracuse|US*,Syracuse University|Syracuse|United States
T-Method|Chiba|Japan*
Tableau Software|Seattle|US*,Tableau Software|Seattle|United States
Tallinn University|Tallinn|Estonia*
Tampere University of Technology|Tampere|Finland*
"Teachers College, Columbia University|New York City|US*","Teachers College, Columbia University|New York City|United States","Teachers College, Columbia University|New York|USA"
"TecEd, Inc.|Ann Arbor|US*","TecEd, Inc.|Ann Arbor|United States"
Technical Research Centre of Finland|Espoo|Finland*
Technical University of Catalonia|Castelldefels|Spain*
Technical University of Crete|Chania|Greece*,Technical University Crete|Chania|Greece,Technical University of Crete|Chania|Greece,Technical University of Crete|Chania|Greece
Technical University of Denmark|Lyngby|Denmark*
Technical University of Lisbon|Lisbon|Portugal*
Technical University of Valencia|Valencia|Spain*
Technical University Vienna|Vienna|Austria*
Technische Universiteit Eindhoven|Eindhoven|The Netherlands*
"Technologies for health behaviour change, VTT Technical Research Centre of Finland, Tampere|Tampere|Finland*","Technologies for health behaviour change, VTT Technical Research Centre of Finland, Tampere|Tampere|Finland"
Technology and Social Behavior|Evanston|US*,Technology and Social Behavior|Evanston|United States
Technosite|Madrid|Spain*,TEchnosite|Madrid|Spain
Teesside University|Middlesbrough|UK*,Teesside University|Middlesbrough|United Kingdom
Tel Aviv University|Tel Aviv|Israel*
Telecom Italia|Milano|Italy*
Telecom Italia|Turin|Italy*
Telefonica Research|Barcelona|Spain*
Telekom Innovation Laboratories|Berlin|Germany*,Telekom Innovation Lab|Berlin|Germany,Telekom Innovation Laboratories|Berlin|Germany
Temasek Polytechnic|Singapore|Singapore*,Temasek Polytechnic|Singapore|Singapore,Temasek Polytechnic|Singapore|Singapore
TERC|Cambridge|US*,TERC|Cambridge|United States
Texas A&M University|College Station|US*,Texas A & M University|College Station|United States,"Texas A&M University, College Station|College Station|United States",Texas A&M University|College Station|United States,Texas A&M University|college station|United States,Texas A&M Universty|College Station|United States
Texas State University|San Marcos|US*,Texas State University|San Marcos|United States
Texas Tech University|Lubbock|US*,Texas Tech Univeristy|lubbock|United States,Texas Tech University|Lubbock|United States
Thales Research & Technology France|Paris|France*
The Chinese University of Hong Kong|Shatin|Hong Kong*
The DuKode Studio|Brooklyn|US*,The DuKode Studio|Brooklyn|USA,The DuKode Studio|Brooklyn|United States
The Graduate Univ. for Advanced Studies|Tokyo|Japan*
The Hague University of Applied Sciences|The Hague|The Netherlands*,The Hague University of Applied Sciences|The Hague|Netherlands
The Hong Kong Polytechnic University|Kowloon|Hong Kong*,The Hong Kong Polytechnic University|Hung Hom|Hong Kong
The Hong Kong University of Science and Technology|Hong Kong|China*
The MITRE Corporation|Bedford|US*,The MITRE Corporation|Bedford|United States
The MITRE Corporation|McLean|US*,The MITRE Corporation|McLean|United States
The Open University of Japan|Mihama-ku|Japan*
The Open University|London|UK*,"The Open University, UK|London|United Kingdom"
The Open University|Milton Keynes|UK*,The Open University|Milton Keynes|United Kingdom,The Open University|Milton Keynes|United Kingdom,Open University|Milton Keyens|United Kingdom,Open University|Milton Keynes|United Kingdom,Open Univeristy IET|Milton keynes|United Kingdom,"Department of Computing, The Open University|Milton Keynes|United Kingdom"
The Pennsylvania State University|State College|US*,the Pennsylvania State University|State College|United States,The Pennsylvania State University|State College|United States
The Pennsylvania State University|University Park|US*,"The Pennsylvania State University, University Park, PA|University Park|United States",The Pennsylvania State University|University Park|United States,The Pennsylvania State University|University Park|U.S.A.
The Smith-Kettlewell Eye Research Institute|San Francisco|US*,The Smith-Kettlewell Eye Research Institute|San Francisco|United States
The University of Auckland|Auckland City Campus|New Zealand*,The University of Auckland|Auckland|New Zealand
The University of British Columbia|Vancouver|Canada*
The University of Electro-Communications|Tokyo|Japan*,The University of Electro Communication|Chofu|Japan,The University of Electro Communication|Chofu|Japan,"The University of Electro-communications|Chofu, Tokyo|Japan",The University of Electro-Communications|Chofu|Japan
The University of Hong Kong|Hong Kong|Hong Kong*,The University of Hong Kong|Pokfulam|Hong Kong
The University of Manchester|Manchester|UK*,The University of Manchester|Manchester|United Kingdom
The University of Melbourne|Melbourne|Australia*,The University of Melbourne|Melbourne|Australia,The University of Melbourne|Melbourne|Australia
The University of New South Wales|Canberra|Australia*
The University of New South Wales|Sydney|Australia*,the University of New South Wales|Sydney|Australia,the University of New South Wales|Sydney|Australia,the University of New South Wales|Sydney|Australia
The University of North Carolina at Chapel Hill|Chapel Hill|US*,The University of North Carolina at Chapel Hill|Chapel Hill|United States
The University of North Carolina at Charlotte|Charlotte|US*,The University of North Carolina at Charlotte|Charlotte|United States
The University of Nottingham|Nottingham|UK*,The University of Nottingham|Nottingham|United Kingdom
The University of Sussex|Brighton|UK*,The University of Sussex|Brighton|United Kingdom
The University of Sydney|Sydney|Australia*
The University of Texas at Austin|Austin|US*,The University of Texas at Austin|Austin|United States
The University of Tokyo/JST ERATO|Tokyo|Japan*
The University of Tokyo|Bunkyo-ku|Japan*,The University of Tokyo|Bunkyo|Japan,the University of Tokyo|Bunkyo-ku|Japan,The University of Tokyo|Bunkyo-ku|Japan
The University of Tokyo|Chiba|Japan*
The University of Tokyo|Meguro-ku|Japan*
The University of Tokyo|Tokyo|Japan*,the Univ. of Tokyo|Tokyo|Japan
The University of Waikato|Hamilton|New Zealand*
The University of Western Ontario|London|Canada*
Theatre Auracaria|Newcastle upon Tyne|UK*,Theatre Auracaria|Newcastle upon Tyne|United Kingdom
TinkerStories|Boston|US*,TinkerStories|Boston|United States
Tohoku University|Sendai|Japan*
Tokyo Institute of Technology|Tokyo|Japan*
Tokyo Institute of Technology|Yokohama|Japan*
Tokyo Metropolitan University|Tokyo|Japan*,Tokyo Metropolitan University|Hino|Japan*
Tokyo University of Agriculture and Technology|Koganei|Japan*
Tokyo University of Technology|Hachioji|Japan*,Tokyo University of Technology|Hachioji|Japan
Toronto Rehab|Toronto|Canada*
Towson University|Towson|US*,Towson University|Towson|United States
Trace Center - University of Wisconsin-Madison|Madison|US*,Trace Center - University of Wisconsin-Madison|Madison|United States
"Trinity College, The University of Dublin|Dublin|Ireland*",Trinity College|Dublin|Ireland,Trinity College Dublin|Dublin|Ireland
Troy University|Troy|US*,Troy University|Troy|United States
Tsinghua University|Beijing|China*,"Tsinghua Unviersity, Beijing|Beijing|China","Department of Computer Science and Technology, Tsinghua University|Beijing|China"
TU Berlin. Telekom Innovation Laboratories|Berlin|Germany*
TU Berlin|Berlin|Germany*
TU Darmstadt|Darmstadt|Germany*
TU Eindhoven|Eindhoven|The Netherlands,"TU Eindhoven, Department of Industrial Design|Eindhoven|Netherlands"
Tufts University|Medford|US*,Tufts University|Medford|USA,Tufts University|Medford|United States
Tulane University|New Orleans|US*,Tulane University|New Orleans|United States
Tweedie Consulting|Bath|UK*,Tweedie Consulting|Bath|United Kingdom
Twist Open Innovations|Bangalore|India*
Twitter|San Francisco|US*,Twitter|San Francisco|United States
U. Nebraska - Lincoln|Lincoln|USA
UBC|Vancouver|Canada*
Ubisoft|Pune|India*
UFRGS|Porto Alegre|Brazil*
UGent|Ghent|Belgium*
"UI Wizards, Inc|San Francisco|US*",UI Wizards|San Francisco|United States,"UI Wizards, Inc|San Francisco|United States"
"ulinkm.com Co.,Ltd.|Wuyishan|China*"
Ulm University|Ulm|Germany*,"Ulm University, Institute of Communications Engineering|Ulm|Germany"
UMBC|Baltimore|US*,UMBC|Baltimore|United States
UMD|College Park|US*,UMD|College Park|United States
Umea Institute of Design|Umea|Sweden*
Umea University|Umea|Sweden*
UMich|ann arbor|United States
unaffiliated|Seattle|United States
unam|mexico city|Mexico
UNC - Chapel Hill|Chapel Hill|US*,UNC - Chapel Hill|Chapel Hill|United States
UNC Charlotte|Charlotte|US*,UNC Charlotte|Charlotte|USA,UNC-Charlotte|Charlotte|United States,UNC Charlotte|Charlotte|United States
Union County Public Schools|Monroe|US*,Union County Public Schools|Monroe|United States
Unister GmbH|Leipzig|Germany*
United Technologies|Hartford|US*,United Technologies|Hartford|United States
Univ Paris-Sud & CNRS|Orsay|France*
"Univ Paris-Sud, CNRS & INRIA, Paris|Paris|France*"
Univ Paris-Sud|Orsay|France,Univ. Paris-Sud|Orsay|France*,Univ Paris-Sud|Orsay|France
Univ. Paul Sabatier|Toulouse|France*
Univercity of Electro-Communications|Chofu|Japan,Univercity of Electro-Communications|Chofu|Japan
Univeristy of Massachusetts Lowell|Lowell|United States,Univeristy of Massachusetts Lowell|Lowell|US
Univeristy of Oslo|Oslo|Norway,Univeristy of Oslo|Oslo|Norway
Univeristy of Oxford|Oxford|UK,Univeristy of Oxford|Oxford|United Kingdom
Univerity of Central Lancashire|Preston|UK,Univerity of Central Lancashire|Preston|United Kingdom
Universidad Autonoma de Baja California|Tijuana|MEXICO*.UNIVERSIDAD AUTONOMA DE BAJA CALIFORNIA|Tijuana|MEXICO
Universidad Carlos III de Madrid|Leganes|Spain*
Universidad Complutense de Madrid (UCM)|Madrid|Spain*
Universidad de Zaragoza (Spain)|Zaragoza|Spain*
Universidad Francisco Marroquin|Guatemala|Guatemala*
Universidad Jaume I|Castellon|Spain*
Universidad Nacional|Heredia|Costa Rica*,universidad nacional|heredia|Costa Rica
Universidad Politecnica de Madrid|Madrid|Spain*
Universidad Publica de Navarra|Pamplona|Spain*
Universidad Rey Juan Carlos|Madrid|Spain*
Universidad Rey Juan Carlos|Mostoles|Spain*
Universidade do Porto|Porto|Portugal*
Universidade Federal do Rio Grande do Sul|Porto Alegre|Brazil*
Universidade Nova de Lisboa|Lisboa|Portugal*
Universidade Tecnica de Lisboa|Lisbon|Portugal*
Universitat Politecnica de Valencia|Valencia|Spain*
Universitat Pompeu Fabra|Barcelona|Spain*
Universite Joseph Fourier|Grenoble|France*
Universiteit Hasselt|Diepenbeek|Belgium*
Universiteit Hasselt|Hasselt|Belgium*
University  of Saskatchewan|Saskatoon|Canada
"University at Albany, State University of New York|Albany|US*","University at Albany, SUNY|Albany|United States","University at Albany, State University of New York|Albany|United States"
University Calgary|Calgary|Canada*
University College Cork|Cork|Ireland*,"University College Cork, Ireland|Cork|Ireland"
University College Dublin|Dublin|Ireland*
University College Falmouth|Falmouth|UK*,University College Falmouth|Falmouth|United Kingdom
University College Falmouth|Penryn|United Kingdom
University College London|London|UK*,University College London|London|United Kingdom,University College of London|London|United Kingdom,University College of London|London|United Kingdom,UCL|London|United Kingdom,University College London|London|UK,University College Lonndon|London|United Kingdom
University Health Network|Toronto|Canada*
University Hospital of Copenhagen|Copenhagen|Denmark*
University Lille|Lille|France*,University Lille |Lille|France,University Lille 1|Lille|France
University Lyon|Bron|France*,University Lyon2|Bron|France
University of  Manitoba|Winnipeg|Canada
University of Aberdeen|Aberdeen|UK*,University of Aberdeen|Aberdeen|United Kingdom
University of Abertay Dundee|Dundee|UK*,University of Abertay Dundee|Dundee|United Kingdom
University of Alabama at Birmingham|Birmingham|US*,University of Alabama at Birmingham|Birmingham|United States
University of Alabama|Tuscaloosa|US*,University of Alabama|Tuscaloosa|United States
University of Amsterdam|Amsterdam|The Netherlands*,University of Amsterdam|Amsterdam|Netherlands
University of Applied Sciences Amberg-Weiden|Amberg|Germany*
University of Applied Sciences Upper Austria|Hagenberg|Austria*,University of Applied Sciences Upper Austria|Hagenberg|Austria,University of Applied Sciences Upper Austria Campus Hagenberg|Hagenberg|Austria
University of Applied Sciences Upper Austria|Wels|Austria*
University of Arts|Berlin|Germany*
University of Auckland|Auckland|New Zealand*,University of Auckland|Auckland|New Zealand,University of Auckland (UoA)|Auckland|New Zealand
University of Aveiro|Aveiro|Portugal*
University of Baltimore|Baltimore|US*,University of Baltimore|Baltimore|United States
University of Bamberg|Bamberg|Germany*
University of Bari|Bari|Italy*
University of Basel|Basel|Switzerland*
University of Bath|Bath|UK*,University of Bath|Bath|United Kingdom,University Of Bath|Bath|United Kingdom,University of Bath|Bath|United Kingdon
University of Birmingham|Birmingham|UK*,University of Birmingham|Birmingham|United Kingdom,university of birmingham|Birmingham|United Kingdom
University of Bochum|Bochum|Germany*
University of Bordeaux|Bordeaux|France*
University of Bordeaux|Talence|France*
"University of Bremen, TZI|Bremen|Germany*"
University of Bremen|Bremen|Germany*
University of Bristol|Bristol|UK*,University of Bristol|Bristol|United Kingdom
University of British Columbia|Vancouver|Canada*,University of Brisith Columbia|Vancouver|Canada,University of British Columbia|Vancouver|Canada
"University of Calfornia, Riverside|Riverside|US*","University of Calfornia, Riverside|Riverside|United States"
University of Calgary|Calgary|Canada*,University of Calgary|calgary|Canada,University of Calgary|Calgary|Canada,university of calgary|calgary|canada
University of California at Santa Cruz|Santa Cruz|US*,University of California at Santa Cruz|Santa Cruz|United States,University of California at Santa Cruzni|Santa Cruz|United States
University of California Berkeley|Berkeley|United States

UC Santa Barbara|Santa Barbara|US*,UC Santa Barbara|Santa Barbara|United States
UC Santa Cruz|Santa Cruz|US*,UC Santa Cruz|Santa Cruz|United States
UCF|Orlando|US*,UCF|Orlando|United States
UCLA|Los Angeles|US*,UCLA|Los Angeles|United States
University of California Santa Cruz|Santa Cruz|United States
"University of California, Berkeley|Berkeley|US*","University of California, Berkeley|Berkeley|USA","University of California, Berkeley|Berkeley|United States","University of California, Berkeley|Berkeley|United states"
"University of California, Irvine|Irvine|US","University of California, Irvine|Irvine|USA",University of California Irvine|Irvine|United States,"University of California, Irvine, Irvine, USA|Irvine|United States","University of California, Irvine|Irvine|United States","Department of Informatics, UC Irvine|Irvine|United States",UC Irvine|Irvine|US*,UC Irvine|Irvine|United States,UC Irvine|Irvine|USA
"University of California, Los Angeles|Los Angeles|US*","University of California, Los Angeles|Los Angeles|United States"
"University of California, Riverside|Riverside|US*","University of California, Riverside|Riverside|USA"
"University of California, San Diego|La Jolla|US*","UC San Diego|La Jolla|US*,UC San Diego|La Jolla|United States,UCSD|La Jolla|United States,University of California, San Diego|La Jolla|United States",University of California San Diego|La Jolla|United States,
"University of California, San Diego|San Diego|US*",UC San Diego|San Diego|US*,UC San Diego|San Diego|United States,UCSD|San Diego|United States,"University of California, San Diego|San Diego|United States",University of California San Diego|San Diego|United States
"University of California, Santa Barbara|Santa Barbara|US*","University of California, Santa Barbara|Santa Barbara|United States"
"University of California, Santa Cruz|Santa Cruz|Santa Cruz*"
University of California|Berkeley|USA,UC Berkeley|Berkeley|US*,UC Berkeley|Berkeley|USA,UC Berkeley|BERKELEY|United States,UC Berkeley|Berkeley|United States

University of Cambridge|Cambridge|UK*,University of Cambridge|Cambridge|United Kingdom
University of Campinas|Campinas|Brazil*
University of Canberra|Canberra|Australia*
University of Canterbury|Christchurch|New Zealand*
University of Cape Town|Cape Town|South Africa*
University of Castilla-La Mancha (UCLM)|Albacete|Spain*,University of Castilla-La Mancha|Albacete|Spain*
University of Central Florida|Orlando|US*,University of Central Florida|Orlando|USA,University Of Central Florida|Orlando|United States,University of Central Florida|Orlando|United States
University of Central Lancashire|Preston|UK*,University of Central Lancashire|Preston|United Kingdom
University of Chicago|Chicago|US*,University of Chicago|Chicago|United States of America
University of Coimbra|Coimbra|Portugal*
University of Colorado|Boulder|US*,University of Colorado|Boulder|United States,"University of Colorado, Boulder|Boulder|United States",University of Colorado at Boulder|Boulder|United States,University of Colorado at Boulder|Boulder|US,University of Colorado Boulder|Boulder|United States,University of Colorado Boulder|Boulder|USA
University of Connecticut|Storrs|US*,University of Connecticut|Storrs|United States
University of Copenhagen|Copenhagen|Denmark,"Department of Computer Science, University of Copenhagen|Copenhagen|Denmark",Copenhagen University|Copenhagen|Denmark
University of Crete|Heraklion|Greece*,"University of Crete, Computer Science Department|Heraklion|Greece"
University of Cyprus|Nicosia|Cyprus,"Department of Computer Science, University of Cyprus|Nicosia|Cyprus"
University of Duisburg-Essen|Duisburg|Germany*
University of Duisburg-Essen|Essen|Germany*
University of Dundee|Dundee|UK*,University of Dundee|Dundee|United Kingdom
University of East Anglia|Norwich|UK*.University of East Anglia|Norwich|United Kingdom
University of Eastern Finland|Joensuu|Finland*
University of Edinburgh|Edinburgh|UK*.University of Edinburgh|Edinburgh|United Kingdom
University of Florida|Gainesville|US*,University of Florida|Gainesville|USA,University of Florida|Gainesville|United States
University of Fortaleza|Fortaleza|Brazil*,UNIVERSITY OF FORTALEZA|Fortaleza|Brazil
University of Freiburg|Freiburg|Germany*
University of Fribourg|Fribourg|Switzerland*
University of Geneva|Geneva|Switzerland*,University of Geneva|GENEVA|Switzerland
University of Genoa|Genoa|Italy*
University of Georgia|Athens|US*,University of Georgia|Athens|United States
University of Glasgow|Glasgow|UK*,University of Glasgow|Glasgow|United Kingdom,university of Glasgow|Glasgow|United Kingdom,"University of Glasgow, UK|Glasgow|United Kingdom"
University of Gothenburg|Gothenburg|Sweden*
University of Granada|Granada|Spain*
University of Graz|Graz|Austria*
University of Grenoble - LIG/IIHM - Grenoble-INP - CNRS|Grenoble|France*
University of Groningen|Groningen|The Netherlands*,University of Groningen|Groningen|Netherlands
University of Guelph|Guelph|Canada*
University of Haifa|Haifa|Israel*
University of Hamburg|Hamburg|Germany*
University of Hannover|Hannover|Germany*
University of Hawaii at Manoa|Honolulu|US*,University of Hawaii at Manoa|Honolulu|United States of America,University of Hawaii at Manoa|Honolulu|United States
University of Helsinki|Helsinki|Finland*
University of Houston|Houston|US*,University of Houston|Houston|United States
University of Iceland|Reykjavik|Iceland*
University of Illinois at Chicago|Chicago|US*,University of Illinois at Chicago|Chicago|United States,University of Illinois - Chicago|Chicago|United States
University of Illinois at Urbana-Champaign|Champaign|US*,University of Illinois at Urbana-Champaign|Champaign|United States,University of Illinois at Urbana Champaign|Urbana|United States
University of Illinois at Urbana-Champaign|Singapore|Singapore*
University of Illinois at Urbana-Champaign|Urbana|United States,"University of Illinois, Urbana-Champaign|Champaign|United States",University of Illinois|Urbana-Champaign|USA,University of Illinois|Urbana|United States
University of Illinois Chicago (UIC)|Chicago|US*,University of Illinois Chicago (UIC)|Chicago|United States
University of Illinois-Urbana|Urbana|United States
"University of Illinois, Chicago|Chicago|United States"
University of Ioannina|Ioannina|Greece*
University of Iowa|Iowa City|US*,University of Iowa|Iowa City|United States
University of Jinan|Jinan|China*
University of Kaiserslautern|Kaiserslautern|Germany*
University of Kiel|Kiel|Germany*
University of Koblenz-Landau|Koblenz|Germany*
University of Konstanz|Konstanz|Germany*
University of Leeds|Leeds|UK*,University of Leeds|Leeds|United Kingdom
University of Leicester|Leicester|UK*,University of Leicester|Leicester|United Kingdom,University of Leicester|University of Leicester|United Kingdom
University of Leuven|Leuven|Belgium*,University of Leuven|Leuven|Belgium
University of Limerick|Limerick|Ireland*
University of Lincoln|Lincoln|UK*,University of Lincoln|Lincoln|United Kingdom
University of Linz|Linz|Austria*,university of linz|linz|Austria
University of Lisbon|Lisbon|Portugal*
University of Lleida|Lleida|Spain*
University of London|London|UK*,University of London|London|United Kingdom
University of Lorraine|Metz|France*
University of Louvain|Louvain-la-Neuve|Belgium*
University of Lugano|Lugano|Switzerland*,University of Lugano (USI)|Lugano|Switzerland,"University of Lugano (USI), Lugano, TI|Lugano|Switzerland"
University of Luxembourg|Luxembourg-Kirchberg|Luxembourg*
University of Lyon - EDF Research & Development|Lyon|France*
"University of Lyon, LIRIS|Villeurbanne F-69621|France*"
University of Madeira|Funchal|Portugal*
University of Magdeburg|Magdeburg|Germany*
University of Malta|Msida|Malta*
University of Manchester|Manchester|UK*,University of Manchester|Manchester|United Kingdom
University of Manitoba|Winnipeg|Canada*
University of Mannheim|Mannheim|Germany*
University of Maryland iSchool|College Park|US*,University of Maryland iSchool|College Park|United States,University of Maryland College Park|College Park|United States
"University of Maryland, Baltimore County|Baltimore|US*","University of Maryland, Baltimore County|Baltimore|United States",University of Maryland Baltimore County|Baltimore|United States
University of Maryland|College Park|US*,University of Maryland|College Park|USA,"University of Maryland, College Park|College Park|United States","University of Maryland, College Park|College Park|USA",University of Maryland|College Park|20742,University of Maryland|College Park|United States
University of Massachusetts Lowell|Lowell|US*,University of Massachusetts Lowell|Lowell|United States
University of Massachusetts|Amherst|US*,University of Massachusetts|Amherst|United States,University of Massachusetts Amherst|Amherst|United States
University of Melbourne|Melbourne|Australia*
University of Memphis|Memphis|US*,University of Memphis|Memphis|United States
University of Michigan|Ann Arbor|US*,University of Michgian|Ann Arbor|United States,University of Michgian|Ann Arbor|United States,University of Michigan School of Information|Ann Arbor|United States,"University of Michigan, School of Information|Ann Arbor|United States","University of Michigan, School of Information|Ann Arbor|US*",University of Michigan|Ann Arbor|United States,University of Michigan|Ann Arbor|US
University of Minho|Braga|Portugal*
University of Minnesota|Duluth|US*,University of Minnesota|Duluth|United States
University of Minnesota|Minneapolis|US*,University of Minnesota|Minneapolis|USA,University of Minnesota|Minneapolis|United States
University of Monash|Melbourne|Australia*,university of monash|melbourne|Australia
University of Munich (LMU)|Munich|Germany*,University of Munich|Munich|Germany,University of Munch (LMU)|Munich|Germany
"University of Nebraska, Lincoln|Lincoln|US*",University of Nebraska-Lincoln|Lincoln|United States,University of Nebraska-Lincoln|Lincoln|United States,"University of Nebraska, Lincoln|Lincoln|United States"
"University of Nevada, Reno|Reno|US*",University of Nevada|Reno|United States,"University of Nevada, Reno|Reno|United States"
University of New Hampshire|Durham|US*,University of New Hampshire|Durham|United States
University of New Mexico|Albuquerque|US*,University of New Mexico|Albuquerque|United States
University of New York at Albany|Albany|US*,University of New York at Albany|Albany|USA
University of Nicosia|Nicosia|Cyprus,"Department of Management and MIS, University of Nicosia|Nicosia|Cyprus"
University of North Carolina at Charlotte|Charlotte|US*,University of North Carolina Charlotte|Charlotte|United States,University of North Carolina at Charlotte|Charlotte|U.S.A,University of North Carolina at Charlotte|Charlotte|United States
University of North Carolina-Chapel Hill|Chapel Hill|US*,University of North Carolina|Chapel Hill|United States,University of North Carolina-Chapel Hill|Chapel Hill|United States
University of Northumbria|Newcastle-upon-Tyne|UK*,University of Northumbria|Newcastle-upon-Tyne|United Kingdom,"School of Design, Northumbria University|Newcastle upon Tyne|United Kingdom"
University of Notre Dame|Notre Dame|US*,University of Notre Dame|Notre Dame|United States
University of Nottingham|Nottingham|UK*,University of Nottingham|Nottingham|United Kingdom,University of Nottingham|Nottingham|United Kingdom,University of Nottingham|Nottingham|Enagland
University of Oklahoma|Norman|US*,University of Oklahoma|Norman|United States
University of Oldenburg|Oldenburg|Germany*
University of Ontario Institute of Technology|Oshawa|Canada*,University of Ontario Institute of Technology (UOIT)|Oshawa|Canada
University of Oslo|Oslo|Norway*
University of Otago|Dunedin|New Zealand*
University of Oulu|Oulu|Finland*,University Of Oulu|Oulu|Finland
University of Oxford|Oxford|UK*,University of Oxford|Oxford|United Kingdom
University of Padova|Padova|Italy*
University of Patras|Patras|Greece*
University of Pavia|Pavia|Italy*
University of Pennsylvania|Philadelphia|US*,University of Pennsylvania|Philadelphia|USA,University of Pennsylvania|Philadelphia|United States
University of Pittsburgh|Pittsburgh|US*,University of Pittsburgh|Pittsburgh|USA,University of Pittsburgh|Pittsburgh|United States
University of Porto|Porto|Portugal*
University of Primorska|Koper|Slovenia*
University of Puget Sound|Tacoma|US*,University of Puget Sound|Tacoma|USA
University of Rochester|Rochester|United States,University of Rochester|Rochester|US*
University of Rostock|Rostock|Germany*
University of Salzburg|Salzburg|Austria*,"University of Salzburg - ICT&S, Salzburg, Salzburg|Salzburg|Austria",University of Salzburg - ICT&S|Salzburg|Austria,University of Salzburg|Salzburg|Austria
University of Santa Cruz|Santa Cruz|US*,University of Santa Scruz|Santa Cruz|United States,University of Santa Cruz|Santa Cruz|United States
University of Saskatchewan|Saskatoon|Canada*,University of Saskatchewan|Saskatoon|Canada,University of Saskatchewan|Saskatoon|Canada
University of Science and Technology of China|Hefei|China*
University of Sheffield|Sheffield|UK*,University of Sheffield|Sheffield|United Kingdom
University of Siegen and Fraunhofer FIT|Siegen|Germany*
University of Siegen|Siegen|Germany*
University of Siena|Siena|Italy*
University of Social Sciences and Humanities|Warszawa|Poland*,University of Social Sciences and Humanities|Warszawa|Poland,University of Social Sciences and Humanities|Warszawa|Poland
University of South Carolina|Columbia|US*,University of South Carolina|Columbia|United States
University of South Florida|Tampa|US*,University of South Florida|Tampa|United States
University of Southampton|Southampton|UK*,University of Southampton|Southampton|United Kingdom,University of Southampton|southampton|United Kingdom,University of Southampton|SOUTHAMPTON|UK,University of Southampton|Southampton|UK
University of Southern California|Los Angeles|US*,University of Southern California|Los Angeles|United States,University of Southern California|Los Angeles|United States
University of Southern Denmark|Kolding|Denmark*
University of Split|Split|Croatia*
University of St Andrews|St Andrews|UK*,University of St Andrews|St Andrews|United Kingdom
University of Strathclyde|Glasgow|UK*,University of Strathclyde|Glasgow|United Kingdom,"University of Strathclyde, UK|Glasgow|United Kingdom"
University of Stuttgart|Stuttgart|Germany*,"University of Stuttgart, Stuttgart|Stuttgart|Germany"
University of Sunderland|Sunderland|UK*,University of Sunderland|Sunderland|United Kingdom
University of Surrey|Guildford|UK*,University of Surrey|Guildford|United Kingdom
University of Sussex|Brighton|UK*,University of Sussex|Brighton|United Kingdom,"University of Sussex|Falmer, Brighton|United Kingdom",University of Sussex|Falmer|United Kingdom
University of Sydney|Sydney|Australia*
University of Tallinn|Tallinn|Estonia*
University of Tampere|Tampere|Finland*
University of Tasmania|Hobart|Australia*
University of Tasmania|Launceston|Australia*
University of Technology Sydney|Sydney|Australia
"University of Technology, Sydney|Sydney|Australia"
"University of Technology, Sydney|Ultimo|Australia"
"University of Technology, Sydney|Ultimo|Australia*"
University of Technology|Sydney|Australia*
University of Texas at Austin|Austin|US*,University of Texas|Austin|United States,University of Texas at Austin|Austin|United States
University of the Philippines Open University|College|Philippines*
University of the Sunshine Coast|Maroochydore|Australia*
University of the West of England|Bristol|UK*,University of the West of England|Bristol|United Kingdom
University of the Witwatersrand|Joh|South Africa*
University of Tokyo / Sony CSL|Meguro-ku|Japan*
University of Tokyo|Tokyo|Japan*
University of Toronto|Toronto|Canada*
University of Toulouse|Toulouse|France*,University of Toulouse|Tolouse|France
University of Trento|Trento|Italy*
University of Tsukuba|Tsukuba|Japan*
University of Turin|Turin|Italy*
University of Twente|Enschede|The Netherlands*,University of Twente|Enschede|Netherlands
University of Udine|Udine|Italy*
University of Utah|Salt Lake City|US*,University of Utah|Salt Lake City|United States
University of Victoria|Victoria|Canada*,University of Victoria|victoria|Canada
University of Vienna|Vienna|Austria*
University of Virginia|Charlottesville|US*,University of Virginia|Charlottesville|United States
University of Waikato|Hamilton|New Zealand*
University of Warsaw|Warszawa|Poland*
University of Warwick|Coventry|UK*,University of Warwick|Coventry|United Kingdom
University of Washington|Seattle|US*,University of Washington|Seattle|USA,University of Washington|Seattle|United States,University of Washingtion|Seattle|USA,University of Washington (UW)|Seattle|United States,"University of Washington, Information School|Seattle|United States"
University of Waterloo|Waterloo|Canada*,university of waterloo|waterloo|Canada,"University of Waterloo, Waterloo|Waterloo|Canada"
University of West London|london|UK*,University of West London|london|United Kingdom
University of Western Ontario|London|Canada*
"University of Wisconsin, Madison|Madison|US*","University of Wisconsin, Madison|Madison|United States",University of Wisconsin - Madison|Madison|United States,University of Wisconsin-Madison|Madison|United States,University of Wisconsin-Madison|Madison|USA
University of Worcester|Worcester|United Kingdom,University of Worcester|Worcester|UK*
University of Wyoming|Laramie|US*,University of Wyoming|Laramie|United States
University of York|York|UK*,University of York|York|United Kingdom,University of York|York YO10 5GH|United Kingdom,"University of York|York, YO10 5GH|United Kingdom"
University of Zaragoza|Zaragoza|Spain*,University of Zaragoza (Spain)|Zaragoza|Spain
University of Zurich|Zurich|Switzerland*
University Pompeu Fabra|Barcelona|Spain*
University Siegen|Siegen|Germany
University Stefan cel Mare of Suceava|Suceava|Romania*
University Toulouse 3 & CNRS|Toulouse|France*
University|kanagawa|Japan,University|Kanagawa|Japan
University|Konstanz|Germany
University|Siegen|Germany
Unviersity of Washington|Seattle|US*,Unviersity of Washington|Seattle|United States
"Uplift, Inc.|Washington|US*","Uplift, Inc.|Washington|United States"
Uppsala University|Uppsala|Sweden*
User Interface Design GmbH|Ludwigsburg|Germany*
Utah State University|Logan|US*,Utah State University|Logan|United States
Utrecht University|Utrecht|The Netherlands*,Utrecht University|Utrecht|Netherlands
UVHC|Valenciennes|France*,UVHC|Valenciennes|France,UVHC|valenciennes|France
UX Design Edge|St Albans|US*,UX Design Edge|St Albans|USA
UXLabs|London|UK*,UXLabs|London|United Kingdom
Valdosta State University|Valdosta|US*,Valdosta State University|Valdosta|United States
"Vanderbilt University|2209 Garland Avenue, Nashville 37205|US*","Vanderbilt University|2209 Garland Avenue, Nashville 37205|United States"
Vienna University of Economics and Business|Vienna|Austria*
Vienna University of Technology|Vienna|Austria*,Vienna University of Technology|Vienna|Austria,Vienna University of Technology|Vienna|Austria,"Vienna University of Technology, ICT|Vienna|Austria"
Virginia Polytechnic Institute and State University|Blacksburg|US*,Virginia Polytechnic Institute and State University (Virginia Tech)|Blacksburg|United States,Virginia Polytechnic Institute and State University|Blacksburg|United States
Virginia Tech|Blacksburg|US*,Virginia Tech|Blacksburg|United States
"Vis Center,UNC Charlotte.|Charlotte|US*","Vis Center,UNC Charlotte.|Charlotte|United States"
Vision & Logic|Lincoln|US*,Vision & Logic|Lincoln|United States
Visualization and Interactive Systems Institute; University of Stuttgart|Stuttgart|Germany*
VISUS|Stuttgart|Germany*
Vodafone Group Services|Duesseldorf|Germany*
Volkswagen Group of America|Belmont|US*,Volkswagen Group of America|Belmont|United States
Vrije Universiteit Brussel|Brussels|Belgium*
VTT Technical Research Center Finland|Espoo|Finland*
VTT Technical Research Centre of Finland|Oulu|Finland*
VTT Technical Research Centre of Finland|Tampere|Finland*,"VTT Technical Research Centre of Finland, Tampere|Tampere|Finland"
VU University Amsterdam|Amsterdam|The Netherlands*,VU University Amsterdam|Amsterdam|Netherlands
Warsaw School of Social Psychology|Poznan|Poland*
Warsaw School of Social Psychology|Warsaw|Poland*
Waseda University|Shinjuku|Japan*
Waseda University|Tokyo|Japan*
Washington State University|Pullman|US*,Washington State University|Pullman|United States
Washington University in St. Louis|St. Louis|US*,Washington University in St. Louis|St. Louis|United States
Wearable Computing Lab.|Zurich|Switzerland*,"Wearable Computing Lab., ETH Zurich, Zurich|Zurich|Switzerland"
Weizmann Institute of Science|Rehovot|Israel*
Wellesley College|Wellesley|US*,Wellesley College|Wellesley|USA,Wellesley College|Wellesley|United States
Willow Garage|Menlo Park|US*,Willow Garage|Menlo Park|United States
Worcester Polytechnic Institute|Worcester|US*,Worcester Polytechnic Institute|Worcester|United States
Wuyi University|Wuyishan|China*
Xerox Innovation Group|Grenoble|France*
Xerox Research Center Europe|Meylan|France*,Xerox Research Centre Europe|Meylan|France
Xerox Research Centre Europe|Grenoble|France*,Xerox Research Center Europe|Grenoble|France
Xerox Research Centre India|Bangalore|India*
Xerox|Webster|US*,Xerox|Webster|United States
Xi'an Jiaotong University|Xi'an|China*
Xi'an Jiaotong-Liverpool University|Suzhou|China*
XRCE Xerox|Meylan|France*
Yahoo! Labs|Barcelona|Spain*
Yahoo! Labs|Haifa|Israel*
Yahoo! Research|San Francisco|US*,Yahoo! Research|San Francisco|United States
Yahoo! Research|Santa Clara|US*,Yahoo! Research|Santa Clara|United States
Yahoo! Research|Sunnyvale|US*,Yahoo! Research|Sunnyvale|United States
Yahoo!|Santa Clara|US*,Yahoo!|Santa Clara|United States
Yildiz Technical University|Istanbul|Turkey*
York University|Toronto|Canada*
Zhejiang University of Technology|Hangzhou|China,Zhejiang University|Hangzhou|China
Institue of HCI & Multimedia Tsinghua University|Beijing|China*
school of optoelectronics|beijing|China
School of Software Engineering|Beijing|China*,School of Software Engineering|Beijing|China
BILTIR / Middle East Technical University|Ankara|Turkey*,BILTIR / Middle East Technical University|Ankara|Turkey,BILTIR/ Middle East Technical University|Ankara|Turkey
"Center for Human Computer Interaction, Virginia Tech|Blacksburg|United States"
"Center for Human-Computer Interaction, Virginia Tech, Blacksburg|Blacksburg|United States"
Center for Human-Computer Interaction|Blacksburg|United States
Center for Internet Excellence (CIE)|Oulu|Finland*
"Center for Internet Excellence / CIE, Oulu|Oulu|Finland"
Center for Internet Excellence / CIE|Oulu|Finland
"Center for User Experience Research (CUO), K.U.Leuven|Leuven|Belgium"
Center for User Experience Research (CUO)|Leuven|Belgium*
Central Saint Martins College of Art and Design|London|UK*,Central St Martins|London|United Kingdom
Centre de Recherche Public Henri Tudor|Luxembourg|Luxembourg*
Centre for Intermedia|Exeter|UK*,Centre for Intermedia|Exeter|United Kingdom
Centre for Pattern Recognition and Data Analytics|Geelong|Australia*
Centre for Sustainable Communications|Stockholm|Sweden*
Department of Computer Science and Information Engineering|Taipei|Taiwan,Department of Computer Science and Information Engineering|Taipei|Taiwan,Department of Computer Science and Information Engineering|Taiwpei|Taiwan
Department of Computer Science|Kiel|Germany
Department of Computer Science|Urbana|United States
Department of Computing and Systems Sciences|Stockholm|Sweden
Department of Industrial and Commercial Design|Taipei|Taiwan (R.O.C.)
Department of Information Science|Dunedin|New Zealand
Department of networked systems and services|Oslo|Norway
Department of Psychology|Helsinki|Finland
"Department of Applied IT, IT University, Gothenburg University|Gothenburg|Sweden",Department of Applied IT|Gothenburg|Sweden
"Department of Computer Science and Enginering, University of Oulu|Oulu|Finland"
"School of Communication, Media and Information Technology, Rotterdam University|Rotterdam Univeristy|The Netherlands*","School of Communication, Media and Information Technology, Rotterdam University|Rotterdam Univeristy|Netherlands"
"School of Computer Science, University of Birmingham|Birmingham|United Kingdom"
School of computer|Xi'an|China
School of Computing|Kingston|Canada
"School of Design, Queensland University of Technology|Brisbane|Australia"
School of Design|Changsha|China
"School of Electronic Engineering and Computer Science, Queen Mary University of London|London|United Kingdom"
"School of Geosciences, University of Edinburgh|Edinburgh|United Kingdom"
"School of Informatics & Computing, Indiana University, Bloomington|Bloomington|United States","School of Informatics & Computing, Indiana University|Bloomington|United States","School of Informatics, Indiana University, Indianapolis|Indianapolis|United States","School of Informatics, Indiana University|Bloomington|United States"
School of Information - UC Berkeley|Berkeley|United States
"School of Information Science and Engineering, University of Jinan, China|JiNan|China","School of Information Science and Engineering, University of Jinan, China|JiNan|China"
"School of Information Science, Japan Advanced Institute of Science and Technology|Ishikawa|Japan"
"School of Information Technology, Otago Polytechnic|Dunedin|New Zealand"
"School of Information, University of Michigan, Ann Arbor|Ann Arbor|United States"
School of Interactive Arts + Technology (SIAT)|Surrey|Canada
School of Interactive Arts + Technology (SIAT)|Surrey|Canada*
School of Interactive Arts and Technology|Surrey|Canada
"School of Interactive Computing, Atlanta, United States|Atlanta|United States"
School of Interactive Computing|Atlanta|US*
"School of Library and Information Science, Indiana University Bloomington|Bloomington|United States"
School of Software and Microelectronics|Xi'an|China*
